SayYestoGrayjewelry: SoftsidedJewelry, JoDonJewelry, Lovile, MeltingWithLight, moonspecies
BellaBorsetta: LeChateauWoods, PandoraStyleCharms, JinxiesBeads, TreasuredGems365, JoDonJewelry
APearsonClay: TimothyLandes, MrPaint, PandoraStyleCharms, JinxiesBeads, TreasuredGems365
countrygalclothing: MelindasVintage, PandoraStyleCharms, kidsvintage, Emotionless02, AllthatJunk
MaejohnClothing: DeadbeatCustoms, MeanKids, MamaPileggi, HandPaintedTees, EllePrelleDesigns
StylePowerShop: DeadbeatCustoms, kidsvintage, PandoraStyleCharms, MelindasVintage, JinxiesBeads
VinylGraphix: DigitalDesignz1, PureLoveCrosses, GreatGiftsToGo, PandoraStyleCharms, JinxiesBeads
AshNicoleCreations: FrediaCreations, RosaBlancaBaby, Inspiredbyababy, CammieCouture, BeatriceBent
PoppinToppin: VintageWinery, FiestaFancies, LabiosDeMel, TasteWales, MuseDeFrance
SankofaSoul1: HoopsPlus, VarmCountry, FarahLarki, PaisleyParkVintage, ViviansCrown
akissonthecheek: LivingLifeCreatively, MrPaint, canvasanni, BrilliantIdea, ClemsCards
TenderTatter: MrPaint, nicebabycrochet, BeatriceBent, NaturesHardwear, Inspiredbyababy
ThomsTreasures: NewandOldGifts, GreatValues, MileHillAntiques, AnticqueShop, Emotionless02
GoodWood55: Ducky333, ingrainedwoods2, PCAShoponline, PeculiarPens, HouksWoodworks
CogsandGemscom: SoftsidedJewelry, JoDonJewelry, PickLoveJewelry, YonselDunGenre, OrgonizeYourLife
MyFriend2: PetsLoveBlingToo, MrPaint, JoDonJewelry, PandoraStyleCharms, JinxiesBeads
deasycrafter: GreatGiftsToGo, PureLoveCrosses, OliviasLoops, JoDonJewelry, PandoraStyleCharms
CreativeArtByJMintze: StudioKQL, PhotosbyMM, PandoraStyleCharms, JinxiesBeads, TreasuredGems365
LeiDown: Inspiredbyababy, Jacksembroidery, CammieCouture, kidsvintage, PandoraStyleCharms
LuckyGoldSoap: MrPaint, PandoraStyleCharms, JinxiesBeads, TreasuredGems365, JoDonJewelry
SweetSerendipityCaps: DigitalDesignz1, PureLoveCrosses, GreatGiftsToGo, PandoraStyleCharms, JinxiesBeads
TiggyandMoggy: AtlantaCityBuilders, GoodWood55, KustomIdeas, Ducky333, ingrainedwoods2
Insomny: ViviansCrown, Lovile, OHBracelets, MelindasVintage, PandoraStyleCharms
ArtyDressShop: MyLittleVintageDress, HexzySales, IngridsSkatingDress, SikkFab, ElizaDaysVintage
barargent: TreasuredGems365, PandoraStyleCharms, JinxiesBeads, Jewelryliz, JoDonJewelry
SoundsoftheSeaDesign: CALIHustle, KajunsCrafts, ParacordPatriot, Acmeproducts, Waggonerra1
pantojamaskarts: CHCVProductions, SouthernBlessings002, StantonStudiosArt, lovewideawake, Farelamore
StrangeArts: MastroroccoArt, ArtbyRyanna, BigRedArts, GabesSprayPaintArt, WalkinsWelcome
MirkoClementiDesign: MalikAzarus, Jacksembroidery, barargent, LovelyClassyFinds, MrPaint
FabulouslyFlorida: JinxiesBeads, TreasuredGems365, PandoraStyleCharms, JoDonJewelry, Jewelryliz
RusticRevelations: ArrowsmithForge, OliviasLoops, Back40SignzTexas, Mullicamomsoycandles, MadeByTheRedHead
KellBellsCreations: RagBabyDesigns13, JollyAccessories, OliviaClaireBows, ArtsyiPhoneCases, ChasingSif
EtherealPix: LotusCards, PandoraStyleCharms, JinxiesBeads, TreasuredGems365, Jewelryliz
REKSTUR: LottiesVintageAttic, PartyFlask, ThriftingNifties, MrPaint, aDORYble
littlelittleco: ArtEquine, DearestDaisyUK, TheSnarkade, MamazDesignz, MrPaint
SoulsJourney7: ReformedMetals, SuzysJewelryShop, OnTheBeSide, DangleMeEarrings, AllStarrJewels
StephBeeIllustration: HelloClaireFashion, TheLadyAgnesShoppe, LivingSpiritDesign, PandoraStyleCharms, JinxiesBeads
ZapahNaturals: ParadisesPotpourri, 1818Farms, TheLavenderFarmShop, OdditiesVintage, SudzbyStudz
LostScissorsDesigns: CitySeamsHandbags, BekkaBeek, NotGREY, inmyattictoyours, LovelyClassyFinds
FashionsbyKaren: Emotionless02, MrPaint, MamaPileggi, NULABA, kidsvintage
NikkiSullivanMosaics: JinxiesBeads, TreasuredGems365, Jewelryliz, NeronaStreet, JoDonJewelry
Freedom0421: BirderBob, RegentCollectables, TreasuredTinys, jesske000, beautynpizzazz
LetsTalkTagua: TreasuredGems365, JinxiesBeads, PandoraStyleCharms, Jewelryliz, NeronaStreet
Rosedesignsboutique: MikandIvoLab, ChimericalDesigns, MrPaint, lacova, OliviaClaireBows
GrimCustomGuitar: JoDonJewelry, PandoraStyleCharms, JinxiesBeads, TreasuredGems365, ViviansCrown
jamesnoyes2: TreasuredTinys, KeynoteCollectibles, NewandOldGifts, MileHillAntiques, GreatValues
Grueworks: HoundKat, LottiesVintageAttic, MrPaint, ThriftingNifties, AstronomicalArt
JewelleryByAmandaUK: SuzysJewelryShop, PunkeyMuzzle, OnTheBeSide, DangleMeEarrings, PinnedOnYou
CrazyEmbroidering: AmyHasDesign, EllePrelleDesigns, BonnieBGOODS, HandPaintedTees, MamaPileggi
ClassyAndSassyDecor: DottiesWorld, Craftsbyfitkittymama, TeddyBeartique, MadeByTheRedHead, PillowGroomers
Fashionbyzuzu: AdoreBoutiqueWrexham, MrPaint, EllePrelleDesigns, HandPaintedTees, LulabellesEmbroidery
XorigamiX: AFirstEdition, TribalTees, ArtzMeCrazy, MetalMadeArt, SuelyneeHo
TechTreats: GetKandied, 7on5, Chloescheerbows, ChasingSif, ArtsyiPhoneCases
CharlotteKhanDesigns: Trailblazer28, Tinasuniquedesigns, funjewls4u, Lovile, SoftsidedJewelry
WillowStonePottery: MrPaint, PandoraStyleCharms, JinxiesBeads, TreasuredGems365, JoDonJewelry
CrochetbyRosaG: WeeWhimzyWardrobe, LittlePollyPockets, SweetTeaNme, nicebabycrochet, KCsStudio44
kaesilver: CreatedfortheCreator, Teresafashioncorner, LoveBraceletsByAna, ParacordPatriot, BohemDreams
DualMoonDesigns: JJHut, Lovile, SoftsidedJewelry, MrPaint, PrincessJewelsByCaly
BuffysMixedBag: DIGDIN6, AzMtnBlue, CrystalCoutureDesign, LeChateauWoods, StillTreasured
TissuesandTulipsTwo: PandoraStyleCharms, JinxiesBeads, TreasuredGems365, Jewelryliz, MelindasVintage
silviasjewels: SoftsidedJewelry, JoDonJewelry, Lovile, JJHut, NovaSingularities
PreciousandPersonal: GoodWood55, LottiesVintageAttic, Ducky333, ingrainedwoods2, BashsToyBoxes
MillerRellimMasks: MasksAndProps, PinkSatinSecrets, TheLavenderFarmShop, TutuCarnival, TinkieTies
AuntMolliesHairBows: PandoraStyleCharms, JinxiesBeads, TreasuredGems365, kidsvintage, Jewelryliz
ArtIguana: CreativeArtByJMintze, StudioKQL, MikeHaroArt, PhotosbyMM, GabesSprayPaintArt
ThaiTrendy: inmyattictoyours, LeChateauWoods, CitySeamsHandbags, NotGREY, LovelyClassyFinds
PaisleyParkVintage: MelindasVintage, JoDonJewelry, PandoraStyleCharms, Jewelryliz, JinxiesBeads
JeffPerksJewelry: luadds, JoDonJewelry, junjieshop, NovaSingularities, TreasuredGems365
CMooresCreations: kitchentablelinens, CrystalCoutureDesign, DIGDIN6, AzMtnBlue, FishGirlFashions
StudioKQL: shivajiartstudios, kinkcircuit, RayofSunshineGlass, hereonart, AKBworkshop
ThroughScarf: PandoraStyleCharms, JinxiesBeads, TreasuredGems365, Jewelryliz, JoDonJewelry
KikisGallery: SweetCupCrafts, Dark1art, YleCreations, MrPaint, MMsJewelry
CustomStoneArt: kinkcircuit, ArtByAmaris, shivajiartstudios, AKBworkshop, TheCanvasCorner
Ecohippychic: PandoraStyleCharms, JinxiesBeads, TreasuredGems365, Jewelryliz, JoDonJewelry
Spottymoocow: MadeWithMarzipan, JGHandcraftedCards, ClemsCards, MrPaint, NiismsCards
ElBabyBoutique: RosaBlancaBaby, AshNicoleCreations, OverTheTopDaiperCake, FrediaCreations, Inspiredbyababy
VintageWinery: LabiosDeMel, LeChapelle, TheresaNPieces, PCAShoponline, PandoraStyleCharms
LavantaCoffee: PandoraStyleCharms, JinxiesBeads, TreasuredGems365, Jewelryliz, MelindasVintage
MikandIvoLab: DavidBoydJrFineArt, WalkinsWelcome, LotusCards, EtherealPix, PhotosbyMM
CornholeMe: Ducky333, ingrainedwoods2, Ringo2011, PeculiarPens, PCAShoponline
Luxurygiftscouk: PandoraStyleCharms, JinxiesBeads, TreasuredGems365, Jewelryliz, JoDonJewelry
AHMEDKLINK: PandoraStyleCharms, JinxiesBeads, TreasuredGems365, Jewelryliz, MrPaint
OliviaClaireBows: lacova, JollyAccessories, kidsvintage, ArtsyiPhoneCases, CammieCouture
MoJanaeBeadWorks: Trailblazer28, funjewls4u, Tinasuniquedesigns, CharlotteKhanDesigns, estateandmore
TennesseeCuffLinks: VintageBadass, faboandme, DeadbeatCustoms, StylePowerShop, bluemolasses
crystalillumination: kinkcircuit, shivajiartstudios, AKBworkshop, StudioKQL, MrPaint
Bordartes: COLOURLENSES, ThreadbareLab, WyldeBrambleEmporium, YorktownCrafts, BellaVitaDesignsYona
OneOffGoods: kinkcircuit, shivajiartstudios, AKBworkshop, StudioKQL, RayofSunshineGlass
nicksnnacks: MileHillAntiques, GreatValues, MakeThingsPretty, Emotionless02, jomannjewels
FairytaleHour: RayofSunshineGlass, kidsvintage, hereonart, PandoraStyleCharms, JinxiesBeads
ChelseaLauran: PamiesPatterns, funjewls4u, UnderTheMysticTree, SheebeezAccessories, bylaurab
ForYourBabyCrochet: JeromeMcDonaldArt, junjieshop, StillTreasured, LeChateauWoods, SewSweetTots
TreasuredGems365: JinxiesBeads, Jewelryliz, NeronaStreet, JoDonJewelry, PandoraStyleCharms
KODIScloset: DonnaMaggioDesigns, ZumbaFashions, 60sStore, SatinNTat, goodswithlove
Digitaltomato: SparkleAndCharming, MileHillAntiques, silvertime925, MakeThingsPretty, MrsVintageShoppe
easycases: casesinstyle, ArtsyiPhoneCases, JollyAccessories, DavidHughesCases, OliviaClaireBows
DitsyDiamonds: LynCharms, TRINKETSandTREASURE1, Alyxsthriftyboutique, PunkeyMuzzle, jomannjewels
TheHeartofLoveDesign: KoalaScrawwls, pinkllamaprint, WasteYrPrints, KvoFolkArt, TristanTannerDesigns
PlayneLuv: LeChapelle, designsbyashliet, TwoGuysWed, SewSweetTots, MrPaint
BourgeoisKitsch: MrPaint, BellatiqueFabrics, MamaPileggi, kidsvintage, JoDonJewelry
SkyPirateRadio: dolliesforfroggies, GalaxyBoutique, PhotoMemorobilia, MrPaint, NewandOldGifts
Micottonclub: MrPaint, KCsStudio44, PandoraStyleCharms, JinxiesBeads, TreasuredGems365
SerenityAndLaughter: EtherealPix, LotusCards, LauraInkPhotography, WalkinsWelcome, PhotosbyMM
TheCallofTheOwl: Malamutemax, MrPaint, PandoraStyleCharms, JinxiesBeads, TreasuredGems365
HoundKat: LottiesVintageAttic, ThriftingNifties, JoDonJewelry, PandoraStyleCharms, JinxiesBeads
RobynsJewellery: JoDonJewelry, ViviansCrown, NovaSingularities, OHBracelets, NeronaStreet
NewYorkHatsAndJewels: MelindasVintage, PandoraStyleCharms, TreasuredGems365, JinxiesBeads, Jewelryliz
Meshme: CharmeBeachwear, MrPaint, MamaPileggi, NULABA, kidsvintage
CzaraArt: TristanTannerDesigns, SouthernBlessings002, DMaxArt, pinkllamaprint, WasteYrPrints
JLVsquared: WearableSpoons, SmashedCopper, MMsJewelry, HoopsPlus, PaisleyParkVintage
BellaAmoreShoppe: WashroomEscentials, TheLavenderFarmShop, Mullicamomsoycandles, MrPaint, OdditiesVintage
GuiltyPleasureINK: DimensionZero, NotGREY, TopTopps, CitySeamsHandbags, LovelyClassyFinds
TynemouthSoftware: StinkyStickers, ArtsyiPhoneCases, JollyAccessories, JoDonJewelry, PandoraStyleCharms
JenGrace57: SIXTWENTYTWOEIGHTY, AksesuhrizHOME, ArtbyElizabethK, ArtByAmaris, TheCanvasCorner
brymercreekantiques: MrPaint, PartyFlask, NewandOldGifts, jomannjewels, ThriftingNifties
BleedBlueCrafts: SistersWreaths, LillykinsCrafts, ClassyAndSassyDecor, MyDoorToYourDoor, WreathsByReed
Forbea77: JaggedLittlePill42, ArtForEveryDay, FurryGraphicDesign, MagnoliaStation, TheRocksStar
LittleAlmondsShop: ClemsCards, JGHandcraftedCards, KnotThatNautical, JoDonJewelry, PinOnArt
MarchandCabinCompany: HandmadeChandeliers, Tesher, LottiesVintageAttic, BashsToyBoxes, JKDesigns4303
ColorfulAir: karmonado, Machlev, ChristopherOakden, billjamespainting, FedwellFarm
FishGirlFashions: HandPaintedTees, CrystalCoutureDesign, DIGDIN6, AzMtnBlue, LulabellesEmbroidery
XYZBoardGames: GuineveresGames, MrPaint, PhotosbyMM, PickLoveJewelry, Bearsfromspares1
Shadowsstorm: MrPaint, WeeWhimzyWardrobe, PrincessJewelsByCaly, BlackbirdSecrets, JoDonJewelry
LifeOnTheGoEasy: PinOnArt, AllieAnnsAttic, alittlehopedesigns, HighCottonSouthernCo, SerenitysWay
LauraInkPhotography: LotusCards, EtherealPix, PhotosbyMM, RayofSunshineGlass, PandoraStyleCharms
LoveChuckTaylors: ChesterInc, bluemolasses, ThreadbareLab, WyldeBrambleEmporium, BellaVitaDesignsYona
cozykakes: SugarDame, NULABA, B16Design, PandoraStyleCharms, AllthatJunk
CharleighFayesCloset: ElizaDaysVintage, SikkFab, misterlisters, StillTreasured, SewSweetTots
KustomIdeas: GoodWood55, Ducky333, TiggyandMoggy, AtlantaCityBuilders, ingrainedwoods2
oldnboard: PhotosbyMM, LocalLivingSA, KCsStudio44, JoDonJewelry, CammieCouture
DespyVintage: AllthatJunk, SewSweetTots, Emotionless02, kidsvintage, MelindasVintage
PlushieBallerinas: littlewildlings, MrPaint, KittenSlacks, WeeWhimzyWardrobe, JoDonJewelry
PaintingsforPJ: CraftyLeaves, depressivepaintings, GabesSprayPaintArt, RayofSunshineGlass, hereonart
SellerUKTest1: TheLavenderFarmShop, JoDonJewelry, PandoraStyleCharms, ViviansCrown, JinxiesBeads
FGClassic: AAAANTIQUES, RegentCollectables, AnticqueShop, TheMcMatosCollection, jesske000
NewandOldGifts: Emotionless02, GreatValues, MelindasVintage, kidsvintage, PaisleyParkVintage
SellingOffMyTreasure: MelindasVintage, PandoraStyleCharms, TreasuredGems365, JinxiesBeads, Jewelryliz
BeneathTheBridge: RingmasterPottery, PaviaLee, SuelyneeHo, Sporkions, MrPaint
HaystackshopCG: Lovile, SheebeezAccessories, UnderTheMysticTree, PamiesPatterns, SoftsidedJewelry
SeedWorksMedia: LittleAlmondsShop, DiamondClarity, LivingLifeCreatively, littlewildlings, MrPaint
ChicCher: PigeonPoint, PCAShoponline, Emotionless02, ThriftingNifties, PaisleyParkVintage
TeddyBeartique: Craftsbyfitkittymama, PandoraStyleCharms, JinxiesBeads, TreasuredGems365, JoDonJewelry
ArtsyiPhoneCases: JollyAccessories, OliviaClaireBows, ChasingSif, PandoraStyleCharms, JinxiesBeads
MagicalArtwork: WordPouch, KMAYIllustration, laurenmtrump, LivingSpiritDesign, MrPaint
Bestvariety4u: JaneysThings, Gypsyluxevintage, KeynoteCollectibles, ModernCntry, jesske000
ShamanicMagic: NewYorkHatsAndJewels, MelindasVintage, PandoraStyleCharms, PickLoveJewelry, JinxiesBeads
AtlContainerBouquets: TasteWales, MuseDeFrance, SweetBitesRichmond, PhotosbyMM, JoDonJewelry
KnittedTreats: Bearsfromspares1, lovenikkih, littlewildlings, TheSpottedMushroom, StuffandStuffies
RSVinylCreations: sfdesigns79, EllePrelleDesigns, LulabellesEmbroidery, HandPaintedTees, DMMonogramming
TJMJewelry: JinxiesBeads, TreasuredGems365, Jewelryliz, NeronaStreet, JoDonJewelry
Allansdesign: FERRERMARBLEGRANITE, MENTOSDRIVE, elementofwonder, WheelhouseLeather, CHUCHULove
AfricanPrintFabric: LilBlueBirdy, BellatiqueFabrics, MrPaint, CraftingEssentials, NULABA
Svetlanadoll: AFreeForAll, BlackbirdSecrets, HandcraftsSewCute, Sparkoise, MrPaint
PaintBrushbyHelena: DMaxArt, kinkcircuit, ArtByAmaris, shivajiartstudios, AKBworkshop
SafeHarborHomeBoutiq: CraftsbyAJ, WarmFeelings, WithloveKaty, MrPaint, PandoraStyleCharms
LolaMontejo: SteveSimpsonShop, RingsmuthWelding, FeyMosacis, PauzaDamascusArt, DemoRSShop
kreatywnaprzyjemnosc: OHBracelets, PandoraStyleCharms, JoDonJewelry, TreasuredGems365, NovaSingularities
ByNinaWL: KellBellsCreations, AlenaBlissYou, OhlalaPretties, blgirard2451, JollyAccessories
SpringScarvesAfrica: MrPaint, PandoraStyleCharms, JinxiesBeads, TreasuredGems365, Jewelryliz
jdgphotography: DavidBoydJrFineArt, annimaarit, IGPhoto, WalkinsWelcome, PhotosbyMM
HashemsGrace: LotusCards, WalkinsWelcome, LauraInkPhotography, PhotosbyMM, IridescentPhotos
moonspecies: MeltingWithLight, NeronaStreet, Jewelryliz, SoftsidedJewelry, JoDonJewelry
CatcheDezin: BellaVitaDesignsYona, GabesSprayPaintArt, ProdigyBoutique, MrPaint, MikeHaroArt
ArtbyAyseT: MrPaint, GabesSprayPaintArt, PandoraStyleCharms, JinxiesBeads, TreasuredGems365
NubbensUnlimited: RyanTokoku, DavidHughesCases, MagicalCase, reckon69, SarahRobertsonShop
EclecticismZine: LittleAlmondsShop, LivingLifeCreatively, Malamutemax, MrPaint, MeanKids
inmyattictoyours: LeChateauWoods, Emotionless02, LovelyClassyFinds, jomannjewels, CitySeamsHandbags
Hytek3D: MadeByTheRedHead, PillowGroomers, petalsbymelissa, OliviasLoops, Frederike11
MuseDeFrance: TasteWales, ChasingSif, Chloescheerbows, ArtsyiPhoneCases, JollyAccessories
RetRowArt: EnvelopedElegance, hereonart, RayofSunshineGlass, SweetSugarPixels, creabonbon
TanDeco: XorigamiX, AFirstEdition, TribalTees, ArtzMeCrazy, MetalMadeArt
PaviaLee: PandoraStyleCharms, JinxiesBeads, TreasuredGems365, Jewelryliz, JoDonJewelry
MoonFlowersMagick: KattySwan, GreatGiftsToGo, OliviasLoops, TheLavenderFarmShop, PureLoveCrosses
HomeSlab: PigeonPoint, AllThatGlittersHC, TheThingsTheyCarried, hereonart, RayofSunshineGlass
BlazinBeader: SparklingDezign, MeltingWithLight, moonspecies, SoftsidedJewelry, NeronaStreet
BillsGeekyGoods: SpeakerBlock, bestinsteam, StinkyStickers, ShizzlerMtG, SnicketsSnippets
Wightstitches: AnnaKnittingShop, InStitchezz, PandoraStyleCharms, JinxiesBeads, TreasuredGems365
Rugger1210: StinkyStickers, MadeByTheRedHead, PillowGroomers, petalsbymelissa, OliviasLoops
TheTopShoppe: CakeToppersAndBeyond, JGHandcraftedCards, MrPaint, MadeWithMarzipan, ClemsCards
ArtbyElizabethK: ArtByAmaris, TheCanvasCorner, kinkcircuit, shivajiartstudios, AKBworkshop
SparklyThingsSupply: CraftingEssentials, ShoppingInParis, PandoraStyleCharms, JinxiesBeads, TreasuredGems365
TobisPlace: GreatValues, LocalLivingSA, JoDonJewelry, KCsStudio44, CammieCouture
TheVintageTeaSet: TreasuredTinys, PandoraStyleCharms, JinxiesBeads, TreasuredGems365, MelindasVintage
TheBowSnob: kidsvintage, PandoraStyleCharms, JinxiesBeads, TreasuredGems365, Jewelryliz
FusionofHomeandHeart: CreationsMade4You, Delightofy, TotallyTutuAwesome, YazzyandMeCreations, MegFranBands
MonsterComicBooks: Malamutemax, MelindasVintage, Emotionless02, kidsvintage, PandoraStyleCharms
BrightFlowerHeadband: LanaArta, GlitteryBugz, BlueRibbonBling, Chloescheerbows, ChasingSif
ArtCreationsByTami: SweetPeaBoogie, ShockCreative, PosterJo, BOMBcutz, MrPaint
BonnieBGOODS: TheLadyAgnesShoppe, PandoraStyleCharms, JinxiesBeads, TreasuredGems365, HelloClaireFashion
AfricanFabric: dummymummyuk, KARYMUSA, nostalgicjapan, BeastetteWristWraps, BellatiqueFabrics
TheEcuadorProject: Insomny, ViviansCrown, Lovile, SheebeezAccessories, PamiesPatterns
DebisDream: PrimPrincess27, OhlalaPretties, lacova, OliviaClaireBows, ArtsyiPhoneCases
FreshwatersScents: TheLavenderFarmShop, MrPaint, JoDonJewelry, PandoraStyleCharms, JinxiesBeads
StickKettleOn: CammieCouture, PandoraStyleCharms, JinxiesBeads, TreasuredGems365, JoDonJewelry
SrAparente: DavidBoydJrFineArt, Malamutemax, laurenmtrump, LivingSpiritDesign, PhotosbyMM
TheresaNPieces: ViviansCrown, Anitahafner, Insomny, JoDonJewelry, Lovile
HandmadeStudioDesign: DoorCountyCreations, StephenWiseDesign, PaviaLee, 2manos, BeachFrontBev
ElMaInterior: GoodWood55, KustomIdeas, LottiesVintageAttic, Ducky333, TiggyandMoggy
DeborahMixBeachHouse: PandoraStyleCharms, JinxiesBeads, TreasuredGems365, LocalLivingSA, Jewelryliz
Dayafternight: AKBworkshop, SweetPeaBoogie, Flintsworld, ZYOENTERTAINMENT, TheThingsTheyCarried
Jewelrybytbling: JoDonJewelry, JinxiesBeads, TreasuredGems365, Jewelryliz, MelindasVintage
MagicalCase: PandoraStyleCharms, JinxiesBeads, TreasuredGems365, Jewelryliz, MelindasVintage
MountainRoseFoods: SweetBitesRichmond, PandoraStyleCharms, JinxiesBeads, TreasuredGems365, JoDonJewelry
WhereDeStash: ShoppingInParis, CraftingEssentials, TeacupMarket, PinnedOnYou, MrPaint
BlaackbirdTreasures: ViviansCrown, OHBracelets, Insomny, MelindasVintage, JoDonJewelry
FedwellFarm: BellaVitaDesignsYona, GabesSprayPaintArt, MikeHaroArt, maryannevansart, LotusCards
Tropicalchick: TheresaNPieces, AllStarrJewels, JAPcreations, EarringsByJane, HomeFeathers
decalCOmania100: LovelyAdmirations, ModernCntry, LocalLivingSA, JoDonJewelry, KCsStudio44
ElenaMercurioDesign: TribalTees, ThreadbareLab, WyldeBrambleEmporium, TopTopps, BellaVitaDesignsYona
ChristiansSix: YorktownCrafts, SweetTeaNme, DespyVintage, HaileyPoo, copperscrafts
BodaciousBeadsbyBrit: Debee333, darebefun, HappyHippyCrafts, MamaRavens, TheAcornFairy
StillTreasured: SewSweetTots, misterlisters, LeChateauWoods, Emotionless02, kidsvintage
SweetSugarPixels: RayofSunshineGlass, hereonart, PandoraStyleCharms, JinxiesBeads, TreasuredGems365
Kirs10sQuilts: RagBabyDesigns13, KellBellsCreations, MrPaint, SuperCuteClippies, JollyAccessories
OwyheeCountryCrafts: MadeByTheRedHead, PillowGroomers, Stormysknotsoflove, petalsbymelissa, OliviasLoops
CGDbyMeryl: PandoraStyleCharms, JinxiesBeads, TreasuredGems365, Jewelryliz, JoDonJewelry
EarthFiredCreations: Hoctavius, Anitahafner, MrPaint, OrgonizeYourLife, NeronaStreet
ThreadbareLab: WyldeBrambleEmporium, BellaVitaDesignsYona, TeaseCouture, misterlisters, LeChateauWoods
JokoCase: EfenCase, ManaCase, SenoCase, CandraCase, JarwoCase
PhotosbyMM: PandoraStyleCharms, JinxiesBeads, TreasuredGems365, Jewelryliz, MelindasVintage
Lizardworx: GoodWood55, Ducky333, ingrainedwoods2, PCAShoponline, PeculiarPens
bellabclothing: MichellesNYC, MikaylasBooks, LovinHateStreet, FayesFabFinds, TRINKETSandTREASURE1
deriedesigns: PinkSatinSecrets, MiSophie, MrPaint, LittleCiciShop, TinkieTies
forsakencloset: BrishtiDecor, Emotionless02, KARYMUSA, NULABA, AllthatJunk
notjustrandomstuff: PigeonPoint, PCAShoponline, Emotionless02, MelindasVintage, kidsvintage
ReformedMetals: PandoraStyleCharms, JinxiesBeads, TreasuredGems365, Jewelryliz, JoDonJewelry
Bookaneerbooks: TheBookCellarmt, Malamutemax, JunkmomsTreasures, OldeDominionAntiques, ModernCntry
loveTshirt: BenBigelowStudio, TeaseCouture, EllePrelleDesigns, LulabellesEmbroidery, HandPaintedTees
CeesGreenCatering: SukkerogSmor, SouthernCakeToppers, MrPaint, SweetBitesRichmond, PetsLoveBlingToo
CreativeCroatian: BrushJunkie, PamiesPatterns, UnderTheMysticTree, SheebeezAccessories, Trailblazer28
FetchingBoutique: KattySwan, OliviasLoops, GaSouthernLights, CollsCoveredBoxes, ohhowcutesigns
JuteByVictoria: CitySeamsHandbags, SandraStitched, LovelyClassyFinds, B16Design, Tekmates
TheOrganizedOwl: GreatGiftsToGo, PureLoveCrosses, OliviasLoops, DigitalDesignz1, PhotosbyMM
Viscarfshop: NanasRuffles, YorktownCrafts, TheLadyAgnesShoppe, ChasingSif, ArtsyiPhoneCases
FallForjewellery: GlyAccessories, EllesHealing, GillianFryer, TheresaNPieces, Anitahafner
Rarebreedantiques: PandoraStyleCharms, MelindasVintage, JinxiesBeads, TreasuredGems365, kidsvintage
AuntieRobinsDolls: ThePaisleyPuppy, LittlePollyPockets, MakeThingsPretty, Emotionless02, MelindasVintage
Fabuology: Dayafternight, MeiForest, AKBworkshop, SweetPeaBoogie, Flintsworld
FiestaFancies: VintageWinery, LabiosDeMel, ArtShoppeCrafts, FlowerStudio13, LeChapelle
DerisSilver: MrPaint, EllesHealing, SellingOffMyTreasure, MeltingWithLight, moonspecies
Kitschcuteandcountry: Emotionless02, MelindasVintage, kidsvintage, PaisleyParkVintage, PandoraStyleCharms
DecoMeshbyDanae: SheekBurlapDesigns, MrPaint, VarmCountry, TissuesandTulipsTwo, PCAShoponline
MomandMeAntiques: ThePaisleyPuppy, barndoorantiques, MakeThingsPretty, LittlePollyPockets, jomannjewels
ABoxInTheBasement: PrincessJewelsByCaly, CourageousCats, Supertogether, PandoraStyleCharms, JinxiesBeads
ElizaDaysVintage: StillTreasured, misterlisters, LeChateauWoods, SewSweetTots, jomannjewels
YorktownCrafts: AlwaysRoomforJello, ArtsyiPhoneCases, JollyAccessories, OliviaClaireBows, misterlisters
HeavenlyrockMedical: MamaPileggi, kidsvintage, SewSweetTots, PandoraStyleCharms, JinxiesBeads
BrilliantIdea: PandoraStyleCharms, JinxiesBeads, TreasuredGems365, LeChapelle, JoDonJewelry
Jewelrydreamers: fashioncomesfirst, Lovile, SoftsidedJewelry, CreationsByChristie2, Insomny
madewithnaunaslove: Inspiredbyababy, LeiDown, CammieCouture, MrPaint, kidsvintage
TheCharlestonBelle: GreatGiftsToGo, PureLoveCrosses, MrPaint, LavantaCoffee, OliviasLoops
3rdWorldMilitant: DMMonogramming, GeekJock, MamaPileggi, kidsvintage, PandoraStyleCharms
jolantakrajewska: WearableSpoons, JinxiesBeads, TreasuredGems365, PandoraStyleCharms, Jewelryliz
Settledownfurnishing: JKDesigns4303, Tinasuniquedesigns, PerfectlyPoshParties, MrPaint, LottiesVintageAttic
WreathsByReed: SistersWreaths, MantisDesign, SheekBurlapDesigns, PigeonPoint, ThriftingNifties
GemmasCreations87: casesinstyle, JollyAccessories, ArtsyiPhoneCases, PandoraStyleCharms, JinxiesBeads
HiddenDrawerVintage: DaneensVintagePics, StillTreasured, misterlisters, LeChateauWoods, SewSweetTots
GoodeGirlVintage: MelindasVintage, Emotionless02, kidsvintage, PandoraStyleCharms, PaisleyParkVintage
alphaascute: MrPaint, MelindasVintage, PandoraStyleCharms, kidsvintage, TreasuredTinys
SteveSimpsonShop: LolaMontejo, RingsmuthWelding, FeyMosacis, PauzaDamascusArt, DemoRSShop
LovelyAdmirations: HouksWoodworks, Back40SignzTexas, JollyAccessories, RagBabyDesigns13, PrimPrincess27
Scubasteve77: TurnerandPoochlathe, KevinsWoodandMore, KustomIdeas, TiggyandMoggy, AtlantaCityBuilders
SimplyTs: PetsLoveBlingToo, RuffsNStuffs, PhotosbyMM, JoDonJewelry, MindCraftCreations
SukkerogSmor: PandoraStyleCharms, JinxiesBeads, TreasuredGems365, Jewelryliz, JoDonJewelry
BLUSHwInnocence: MrPaint, GreatGiftsToGo, PureLoveCrosses, OliviasLoops, DigitalDesignz1
AGirlLikeAnyOther: TartyFrog, Malamutemax, MrPaint, PhotosbyMM, JoDonJewelry
MRNicholas: maryannevansart, DebOller, FeralShop, WasteYrPrints, pinkllamaprint
DavidHughesCases: casesinstyle, PandoraStyleCharms, JinxiesBeads, TreasuredGems365, Jewelryliz
TribalTees: TopTopps, MamaPileggi, kidsvintage, PandoraStyleCharms, JinxiesBeads
TopPetz: PetsLoveBlingToo, KnotThatNautical, JoDonJewelry, PandoraStyleCharms, JinxiesBeads
FERRERMARBLEGRANITE: MENTOSDRIVE, Chloescheerbows, ChasingSif, ArtsyiPhoneCases, JollyAccessories
VintageIngenue: PaisleyParkVintage, MelindasVintage, JoDonJewelry, PandoraStyleCharms, Jewelryliz
BeastetteWristWraps: SANTAFELEATHER, NULABA, B16Design, PandoraStyleCharms, JinxiesBeads
etrePHOTos: LotusCards, PhotosbyMM, TheLadyAgnesShoppe, RayofSunshineGlass, hereonart
HeavenlySoapsAndSuch: SudzbyStudz, TheLavenderFarmShop, KillinTimeCrafting, MrPaint, PandoraStyleCharms
WashroomEscentials: MrPaint, PandoraStyleCharms, JinxiesBeads, TreasuredGems365, JoDonJewelry
UnbridledIrony: BettyFinds, copperscrafts, CraftsbyAJ, TissuesandTulipsTwo, BeatriceBent
dollslittlecloset: JoDonJewelry, PandoraStyleCharms, JinxiesBeads, TreasuredGems365, Jewelryliz
KiddosKustoms: RosaBlancaBaby, AshNicoleCreations, FrediaCreations, Inspiredbyababy, MaddThreads
FindersKeepersPutnam: NewandOldGifts, GreatValues, PandoraStyleCharms, MelindasVintage, kidsvintage
Frederike11: ribbonextravaganza, coralnbeads, dummymummyuk, Ecohippychic, PandoraStyleCharms
AvalonMonet: StillTreasured, LeChateauWoods, MamaPileggi, misterlisters, SewSweetTots
EleganceandOrigami: ArtsyiPhoneCases, JollyAccessories, OliviaClaireBows, TinyTrack, ChasingSif
Yourstrulyuk: JoDonJewelry, NovaSingularities, Mintalist, SoftsidedJewelry, TreasuredGems365
AwesomeRawAppleChips: bebehoney, TasteWales, MuseDeFrance, FluffItBakery, MountainRoseFoods
Liffeyvalephotos: PandoraStyleCharms, JinxiesBeads, TreasuredGems365, Jewelryliz, PhotosbyMM
KasiaWorks: WarmFeelings, SpecialtyTowels, HandmadebyPurplePopp, JoDonJewelry, PandoraStyleCharms
GWYNETHsACCESSORIES: littleBOWSdelivery, OhlalaPretties, KellBellsCreations, AuntMolliesHairBows, SugarDame
Inspiredbyababy: BeatriceBent, FrediaCreations, LeChapelle, CammieCouture, kidsvintage
HandmadeDeblily: Tekmates, MiSophie, SandraStitched, BellatiqueFabrics, MrPaint
gabbadabado: MAJOECREATIONS, ribbonextravaganza, coralnbeads, Frederike11, dummymummyuk
PinkSatinSecrets: kidsvintage, PandoraStyleCharms, JinxiesBeads, TreasuredGems365, JoDonJewelry
MissyAnns: AnticqueShop, CGDbyMeryl, MileHillAntiques, BellaVinoArt, Izzabellas
MissAmybuys: PandoraStyleCharms, JinxiesBeads, TreasuredGems365, Jewelryliz, RayofSunshineGlass
UniqueNUnusual: junjieshop, JoDonJewelry, CynTungFong, Jewelryliz, luadds
ABallAndChainCrochet: MrPaint, AKECreations, KCsStudio44, PandoraStyleCharms, JinxiesBeads
RarRarDesigns: MamaRavens, TheAcornFairy, WonderWomanz, PamiesPatterns, ParacordPatriot
UnitedNation: Farelamore, MissAmybuys, TransPortArt, MikeHaroArt, Natasha354
UrsulaHaugArt: Lovile, SoftsidedJewelry, Insomny, JoDonJewelry, EllesHealing
TheBowTiedAngel: HomeSlab, BJMartwork, Abellans, BlackbirdSecrets, MrPaint
AGreenPalette: PeculiarPens, PCAShoponline, ingrainedwoods2, StephenWiseDesign, PandoraStyleCharms
BlownGlassGoods: PandoraStyleCharms, JinxiesBeads, TreasuredGems365, JoDonJewelry, Jewelryliz
Owldorables: ChocoLolliShop, SweetBeeBaskets, FluffItBakery, TasteWales, BestBakess
BoaNBoo: SistersWreaths, MantisDesign, LanntheClever, SheekBurlapDesigns, MyDoorToYourDoor
NewLightCraftworks: MrPaint, CammieCouture, LittlePollyPockets, NovaSingularities, JoDonJewelry
MobiusCreations: aDORYble, FarahLarki, JinxiesBeads, TreasuredGems365, PandoraStyleCharms
KColorfulCreations: MantisDesign, HaileyPoo, LocalLivingSA, KCsStudio44, ThriftingNifties
MeiForest: LivingSpiritDesign, PandoraStyleCharms, JinxiesBeads, TreasuredGems365, RayofSunshineGlass
RosaryMary: EgyptKoldKollection, MrPaint, JoDonJewelry, TreasuredGems365, JinxiesBeads
ArtForEveryDay: PandoraStyleCharms, JinxiesBeads, TreasuredGems365, backintimeart, Jewelryliz
1616Jewelry: ArtPendant, JinxiesBeads, TreasuredGems365, JoDonJewelry, Jewelryliz
ReclaimeDayton: TheBeautifulLife5, JALDREHouseofCrochet, MrPaint, SweetTeaNme, HaileyPoo
NaturalCure: MatMantra, TheShabbyCraftShack, creationsbyrobyn1, GaSouthernLights, CollsCoveredBoxes
chloeleecrafts: LottiesVintageAttic, ThriftingNifties, ArtsyVeronica, PiperDeveighDesigns, bowsbeforebrosxo
PocketPlushies: littlewildlings, StuffandStuffies, CrochetbyRosaG, KittenSlacks, MiSophie
petalsbymelissa: MadeByTheRedHead, PillowGroomers, OliviasLoops, GaSouthernLights, CollsCoveredBoxes
ShoreBeauties: Anitahafner, TreasuredGems365, JinxiesBeads, JoDonJewelry, Jewelryliz
ArianaZuberCrafts: JumpingJackalope, VarmCountry, TissuesandTulipsTwo, OllieandMrBear, MrPaint
JDCareyMusic: Liffeyvalephotos, PhotosbyMM, JoDonJewelry, EtherealsEden, PandoraStyleCharms
HaleysHandicrafts: DsquaredCraftyCreati, YorktownCrafts, GaeasGreenery, CreationsbyCherylO, NanasRuffles
PeaceLoveeFlowers: MegFranBands, PandoraStyleCharms, JinxiesBeads, TreasuredGems365, Jewelryliz
DancesWithSunkas: paperbagblues, TimothyLandes, StephenWiseDesign, Emotionless02, MelindasVintage
ShorelineCreationsME: MrPaint, PaisleyParkVintage, MelindasVintage, PandoraStyleCharms, JinxiesBeads
Bearsfromspares1: OliviasLoops, MadeByTheRedHead, PillowGroomers, WarmFeelings, GreatGiftsToGo
DIYbyEricaB: PandoraStyleCharms, JinxiesBeads, TreasuredGems365, Jewelryliz, JoDonJewelry
iPadhoodie: KARYMUSA, ChasingSif, ArtsyiPhoneCases, JollyAccessories, OliviaClaireBows
EllisRJones: KnotThatNautical, socraftyuk, JGHandcraftedCards, DearestDaisyUK, ClemsCards
TutuCarnival: MamaPileggi, kidsvintage, misterlisters, SewSweetTots, MrPaint
kbshells: RosaBlancaBaby, AshNicoleCreations, FrediaCreations, Inspiredbyababy, LeChapelle
WondersOfPaper: Jewelryliz, JoDonJewelry, NeronaStreet, TreasuredGems365, JinxiesBeads
MyPenShop: PenSmithDesign, Ducky333, ingrainedwoods2, PeculiarPens, PCAShoponline
Colofonia: DimensionZero, mitchmakesstuff, Michaelajayneart, TopTopps, PixelArtPost
JEMImages: Decorrencia, LeChapelle, LabiosDeMel, PandoraStyleCharms, JinxiesBeads
dieserays: SweetTeaNme, HaileyPoo, copperscrafts, nicebabycrochet, ChansCrochetCreation
WithLovebySim: nicebabycrochet, SweetTeaNme, BeatriceBent, LeChapelle, ChansCrochetCreation
BrasandBabies: AmberandIndigo, ThreadbareLab, WyldeBrambleEmporium, BellaVitaDesignsYona, TeaseCouture
KayleeCrafts: SuzysJewelryShop, OnTheBeSide, DangleMeEarrings, PunkeyMuzzle, AllStarrJewels
CustomCraftsbyChris: GoodWood55, KustomIdeas, Ducky333, TiggyandMoggy, AtlantaCityBuilders
LovelyClassyFinds: MelindasVintage, PandoraStyleCharms, kidsvintage, PaisleyParkVintage, JinxiesBeads
Emmajude: DamnitDolls, WeeWhimzyWardrobe, CoCoMichelles, PhotosbyMM, JoDonJewelry
KvoFolkArt: WasteYrPrints, TheLadyAgnesShoppe, pinkllamaprint, RayofSunshineGlass, hereonart
PearlyArtlondon: BohoJunkie, MrPaint, RayofSunshineGlass, PandoraStyleCharms, JinxiesBeads
BigDaddyElla: SoftsidedJewelry, NovaSingularities, JoDonJewelry, Lovile, UnderTheMysticTree
PatchesNPearls: AlwaysRoomforJello, Inspiredbyababy, BeatriceBent, LeChapelle, NaturesHardwear
CraftBargain: CraftingEssentials, PandoraStyleCharms, JinxiesBeads, TreasuredGems365, Jewelryliz
TheDreamsofaChild: MrPaint, LotusCards, WalkinsWelcome, hereonart, RayofSunshineGlass
ChortzByChloe: shortsbb, HindsightDenim, duckyDenim, RebelRunnerz, ThreadbareLab
MamaPileggi: kidsvintage, SewSweetTots, PandoraStyleCharms, JinxiesBeads, TreasuredGems365
CCraftyCCreations: GoodWood55, KustomIdeas, Ducky333, TiggyandMoggy, AtlantaCityBuilders
soulfulcollection: PandoraStyleCharms, JinxiesBeads, TreasuredGems365, MelindasVintage, Jewelryliz
Heartstrings2ApronSt: KnotThatNautical, JGHandcraftedCards, socraftyuk, ClemsCards, MrPaint
PahaskaBooks: ShopFrozenCharlotte, MelindasVintage, PrintedYesterday, MrPaint, Emotionless02
Yayava: MissyAnns, MichellesNYC, MikaylasBooks, LovinHateStreet, FayesFabFinds
ASLIHOME: TissuesandTulipsTwo, VarmCountry, MelindasVintage, MrPaint, PandoraStyleCharms
ErinsOddsnEnds: JumpingJackalope, PigeonPoint, CatchUOnTheFlipSide, AllThatGlittersHC, StephenWiseDesign
OzarkTimberCustom: WallaceForge, RusticRevelations, Back40SignzTexas, GoodWood55, Ducky333
TipsssssssssShop: MantisDesign, HaileyPoo, LocalLivingSA, KCsStudio44, ThriftingNifties
KevettaDesigns: TartyFrog, ArtShoppeCrafts, FlowerStudio13, MrPaint, LeChapelle
SikkFab: ElizaDaysVintage, misterlisters, StillTreasured, LeChateauWoods, SewSweetTots
AlteoShop: MENTOSDRIVE, MrPaint, SANTAFELEATHER, ArtsyiPhoneCases, MMsJewelry
LePhotographeNY: GreatValues, PandoraStyleCharms, MelindasVintage, kidsvintage, JinxiesBeads
EllieSophiaDesign: ArtShoppeCrafts, FlowerStudio13, PictureYourSeat, LabiosDeMel, VintageWinery
DiddysTreasures: MileHillAntiques, AnticqueShop, TreasuredTinys, GreatValues, LittlePollyPockets
MiscellaneousTrunk: MalikAzarus, LovelyClassyFinds, SellingOffMyTreasure, SparklingDezign, BlazinBeader
Michalinart: mitchmakesstuff, JUMBOkitten, MastroroccoArt, progressiveprint, SummitPosters
PCAShoponline: PeculiarPens, PandoraStyleCharms, JinxiesBeads, TreasuredGems365, Jewelryliz
TheGrids: ParacordPatriot, Lovile, Insomny, SparklingDezign, BlazinBeader
StrayGoddess: DragonflyTease, misterlisters, PrimPrincess27, FanBingBing, MamaPileggi
RainbowsForLilly: CreatedfortheCreator, ParacordPatriot, Teresafashioncorner, LoveBraceletsByAna, BohemDreams
PinnedOnYou: JoDonJewelry, NovaSingularities, TreasuredGems365, JinxiesBeads, PandoraStyleCharms
Acmeproducts: Waggonerra1, ParacordPatriot, CALIHustle, KajunsCrafts, jomannjewels
Lifeinwatercolor4u: FranchaCavitt, backintimeart, RayofSunshineGlass, PandoraStyleCharms, JinxiesBeads
FilterFlowers: MatMantra, TheShabbyCraftShack, creationsbyrobyn1, GaSouthernLights, CollsCoveredBoxes
brianlimaphotography: ImagerybyKevin, CHCVProductions, WalkinsWelcome, LotusCards, DavidBoydJrFineArt
CreationsbyCherylO: junjieshop, TheLadyAgnesShoppe, PandoraStyleCharms, JinxiesBeads, TreasuredGems365
KarensRoses: TheThingsTheyCarried, hereonart, pinkllamaprint, FunFunkyU, RayofSunshineGlass
MyLittleTeeBaby: SunshynesKiddyCloset, PandoraStyleCharms, JinxiesBeads, TreasuredGems365, kidsvintage
Mintalist: TreasuredGems365, JinxiesBeads, JoDonJewelry, PandoraStyleCharms, Jewelryliz
Erdbeerkoepfchen: Hoctavius, KCsStudio44, MMsJewelry, MrPaint, HoopsPlus
elementofwonder: AllthatJunk, SewSweetTots, kidsvintage, MrPaint, MelindasVintage
HopeSpringsEternally: MelindasVintage, MrPaint, PandoraStyleCharms, kidsvintage, Mintalist
GrecoArtStudio: ComputerPictures, MRNicholas, maryannevansart, AlotusArt, DebOller
goodswithlove: iPadhoodie, ChansCrochetCreation, KARYMUSA, AfricanFabric, TwinsiesTotShop
CakeToppersAndBeyond: PandoraStyleCharms, JinxiesBeads, TreasuredGems365, Jewelryliz, JoDonJewelry
PizzazzAndFlare: StanleyOrchard, Atomic39, newyorkarchive, LsCustomCoasters, JaneysThings
VRBoutique: MelindasVintage, PandoraStyleCharms, MrPaint, PaisleyParkVintage, TreasuredGems365
AJMullicanArt: JenGrace57, SIXTWENTYTWOEIGHTY, AksesuhrizHOME, ArtbyElizabethK, ArtByAmaris
CraftsbyAJ: PandoraStyleCharms, JinxiesBeads, TreasuredGems365, Jewelryliz, JoDonJewelry
TelasyAzucar: RosaBlancaBaby, AshNicoleCreations, OverTheTopDaiperCake, ArtShoppeCrafts, FlowerStudio13
Tessvintage5: MichellesNYC, MikaylasBooks, LovinHateStreet, FayesFabFinds, TRINKETSandTREASURE1
moonbeamwoodlove: MegFranBands, PandoraStyleCharms, JinxiesBeads, TreasuredGems365, JollyAccessories
DeSooza: WalkinsWelcome, LotusCards, PhotosbyMM, PandoraStyleCharms, JinxiesBeads
KittenSlacks: PandoraStyleCharms, JinxiesBeads, TreasuredGems365, Jewelryliz, JoDonJewelry
Pirilan: CreatedfortheCreator, BohemDreams, Teresafashioncorner, LoveBraceletsByAna, ParacordPatriot
GalleryWestEnd: LocalLivingSA, JamiesDoodles, MrPaint, TheLadyAgnesShoppe, serendipitypillows
ParadisesPotpourri: Jacksembroidery, JoDonJewelry, PandoraStyleCharms, JinxiesBeads, TreasuredGems365
Battlebalms: TheLavenderFarmShop, 1818Farms, ONLY1NICOLE, MrPaint, PhotosbyMM
BrishtiDecor: LocalLivingSA, LilBlueBirdy, BellatiqueFabrics, serendipitypillows, PandoraStyleCharms
BrownBagNaturalz: RosaBlancaBaby, AshNicoleCreations, FrediaCreations, Inspiredbyababy, Jacksembroidery
ImagineBeading: TinkieTies, KellBellsCreations, RagBabyDesigns13, JollyAccessories, ChasingSif
CreationsbyKariDM: FrediaCreations, TushieTreats, CammieCouture, Inspiredbyababy, NaturesHardwear
SANTAFELEATHER: PandoraStyleCharms, JinxiesBeads, TreasuredGems365, Jewelryliz, MelindasVintage
meansWelcomeinFrench: MamaRavens, TheAcornFairy, WonderWomanz, PamiesPatterns, ParacordPatriot
ArtByGandhi: SteveSimpsonShop, LolaMontejo, RingsmuthWelding, FeyMosacis, PauzaDamascusArt
Wolfhead: GoodWood55, KustomIdeas, LottiesVintageAttic, Ducky333, ingrainedwoods2
Shavingwood: meryprovi, SparklingDezign, BlazinBeader, EllesHealing, TRINKETSandTREASURE1
MyLittleCornerCards: ClemsCards, PandoraStyleCharms, JinxiesBeads, TreasuredGems365, Jewelryliz
GreenCorduroyBook: LittleAlmondsShop, LivingLifeCreatively, Malamutemax, MrPaint, littlewildlings
LuvSiccLA: MetalMadeArt, MamaPileggi, DIGDIN6, AzMtnBlue, misterlisters
TheBeautifulLife5: nicebabycrochet, SweetTeaNme, RosaBlancaBaby, HaileyPoo, AshNicoleCreations
SummitPosters: TristanTannerDesigns, SouthernBlessings002, progressiveprint, RachiPrints, pinkllamaprint
CatalindaFashion: ChesterInc, LoveChuckTaylors, BOMBcutz, bluemolasses, MrPaint
LeCrazionidiSandra: SweetTeaNme, ChansCrochetCreation, nicebabycrochet, ArtsyiPhoneCases, copperscrafts
TheRancorsCrib: NaomisJewelleryshop, MrPaint, LocalLivingSA, KCsStudio44, JoDonJewelry
RSscullery: PandoraStyleCharms, JinxiesBeads, TreasuredGems365, Jewelryliz, JoDonJewelry
AviatorsJewel: jomannjewels, Emotionless02, LeChateauWoods, PaisleyParkVintage, kidsvintage
PurplePlumCrochet: nicebabycrochet, BeatriceBent, LeChapelle, AlwaysRoomforJello, NaturesHardwear
HausofVivienne: Diewithoutit, LeatherChipsChains, LadyBirdesign, GlyAccessories, MENTOSDRIVE
Emotionless02: kidsvintage, MelindasVintage, PandoraStyleCharms, PaisleyParkVintage, JinxiesBeads
StupendouslySweet: ArtShoppeCrafts, FlowerStudio13, PictureYourSeat, LabiosDeMel, VintageWinery
EclipseSkinSolutions: TheLavenderFarmShop, KillinTimeCrafting, PhotosbyMM, JoDonJewelry, BodyOcea
RivetingGallantry: misterlisters, SewSweetTots, AllthatJunk, MamaPileggi, MrPaint
Dyvayva: MaddeeLu, Lemonadedaily, MamaPileggi, ArtsyiPhoneCases, DIGDIN6
TheLovelyLace: JumpingJackalope, MorganAndValley, lovenikkih, ModernCntry, LovelyAdmirations
ClemsCards: PandoraStyleCharms, JinxiesBeads, TreasuredGems365, Jewelryliz, MelindasVintage
SwankySis: DancesWithSunkas, TimothyLandes, paperbagblues, StephenWiseDesign, MileHillAntiques
AAAANTIQUES: RegentCollectables, AnticqueShop, jesske000, beautynpizzazz, Izzabellas
PastTimePickins: Kitschcuteandcountry, TreasuredTinys, PandoraStyleCharms, MelindasVintage, MrPaint
dummymummyuk: Frederike11, ribbonextravaganza, coralnbeads, Ecohippychic, PandoraStyleCharms
FrenchFurniture: KidsChairs, PandoraStyleCharms, JinxiesBeads, TreasuredGems365, Jewelryliz
nitrogeek2012: LottiesVintageAttic, ThriftingNifties, JoDonJewelry, PandoraStyleCharms, JinxiesBeads
TheBreastCookie: Hytek3D, MadeByTheRedHead, PillowGroomers, petalsbymelissa, OliviasLoops
MostlyOneOfAKindVT: KulliMaslova, EvaSzorcFineArt, DogandPetPaintings, MrPaint, TheCritterArtist
kjskreationz: CitySeamsHandbags, LovelyClassyFinds, PamiesPatterns, funjewls4u, TheresaNPieces
SissyandRex: RebelRunnerz, shortsbb, HindsightDenim, IssleFashion, duckyDenim
CollsCoveredBoxes: GaSouthernLights, OliviasLoops, JaimeKupfner, petalsbymelissa, GreatGiftsToGo
EtchGear: NULABA, BellatiqueFabrics, kidsvintage, PandoraStyleCharms, JinxiesBeads
ArtfullyBaked: TasteWales, SukkerogSmor, MuseDeFrance, SouthernCakeToppers, MrPaint
SweetBeeBaskets: OliviasLoops, GreatGiftsToGo, PureLoveCrosses, SweetBitesRichmond, JoDonJewelry
DaretoShop: MyLittleVintageDress, HexzySales, IngridsSkatingDress, SikkFab, ElizaDaysVintage
DesignDecorByAna: AuntieNeeNee, AsherLiving, LottiesVintageAttic, KidsChairs, JKDesigns4303
MatMantra: TheShabbyCraftShack, creationsbyrobyn1, GaSouthernLights, CollsCoveredBoxes, petalsbymelissa
AutoDecor: TheIronGrinder, EreWhile, TartyFrog, TiarasArtCraftCreat, Malamutemax
SewnSweetBoutique: SunshynesKiddyCloset, FrediaCreations, MyLittleTeeBaby, MrPaint, CammieCouture
BettazziBazaar: MantisDesign, DoubleJRusticWorks, PigeonPoint, OllieandMrBear, StinkyStickers
WidowsOilNaturals: TheLavenderFarmShop, MrPaint, PhotosbyMM, JoDonJewelry, PandoraStyleCharms
BelleAnnDesigns: PandoraStyleCharms, JinxiesBeads, TreasuredGems365, Jewelryliz, JoDonJewelry
MoldedOldies: MrPaint, WeeWhimzyWardrobe, BlackbirdSecrets, CoCoMichelles, PhotosbyMM
MyLittleVintageDress: HexzySales, IngridsSkatingDress, SikkFab, ElizaDaysVintage, StillTreasured
LLarabeeStudio: KulliMaslova, TheCritterArtist, MrPaint, RayofSunshineGlass, hereonart
MilaAbstract: PandoraStyleCharms, JinxiesBeads, TreasuredGems365, Jewelryliz, MelindasVintage
LeOndine: DimensionZero, GuiltyPleasureINK, EllePrelleDesigns, LulabellesEmbroidery, HandPaintedTees
EllePrelleDesigns: LulabellesEmbroidery, HandPaintedTees, DMMonogramming, DeadbeatCustoms, MamaPileggi
Collaged2Death: MrPaint, BubblegumBlowfish, RayofSunshineGlass, hereonart, StudioKQL
EspeciallySimple: EgyptKoldKollection, HoopsPlus, CalaJoyeria, Insomny, ViviansCrown
SoulSilk: PandoraStyleCharms, TreasuredGems365, JoDonJewelry, JinxiesBeads, OHBracelets
marble42: MrPaint, Lovile, SoftsidedJewelry, JoDonJewelry, NovaSingularities
CaseOutfitters: RyanTokoku, reckon69, MagicalCase, SarahRobertsonShop, casesinstyle
ErikShermanArt: Machlev, ChristopherOakden, billjamespainting, FedwellFarm, BellaVitaDesignsYona
ShockCreative: SweetPeaBoogie, PosterJo, BOMBcutz, MrPaint, RayofSunshineGlass
bluettine: MrPaint, KidLog, CammieCouture, OliviaClaireBows, kidsvintage
StefaniesNerdCrafts: MikeHaroArt, GabesSprayPaintArt, JeromeMcDonaldArt, StudioKQL, kinkcircuit
AmyDawgsBoutique: PandoraStyleCharms, LoveBraceletsByAna, TreasuredGems365, JinxiesBeads, Jewelryliz
PiercePassions: MantisDesign, DoubleJRusticWorks, CraftsByDre, PigeonPoint, StinkyStickers
ThePaperSpaceship: ClemsCards, SerenitysWay, JGHandcraftedCards, PandoraStyleCharms, JinxiesBeads
Quietbooks4children: lacova, FrediaCreations, OliviaClaireBows, AshNicoleCreations, FishGirlFashions
RingmasterPottery: SuelyneeHo, PandoraStyleCharms, JinxiesBeads, TreasuredGems365, JoDonJewelry
TheRocksStar: ArtByAmaris, ArtbyElizabethK, DMaxArt, kinkcircuit, AKBworkshop
inkandlavender: BillDavisPotteryShop, PartyFlask, MrPaint, Malamutemax, NewandOldGifts
memdreamdesigns: EllieAtMaluno, serendipitypillows, AlwaysRoomforJello, BellatiqueFabrics, DuckDuckDragon
ThePluckyPixie: MrPaint, Anitahafner, MissAmybuys, OrgonizeYourLife, JoDonJewelry
8bitNostalgics: PureLoveCrosses, PandoraStyleCharms, JinxiesBeads, TreasuredGems365, MrPaint
KirisKreations: ChansCrochetCreation, KCsStudio44, PandoraStyleCharms, JinxiesBeads, TreasuredGems365
onevibrantshop: Lifeinwatercolor4u, FranchaCavitt, Gluttonous, ArtbyRyanna, ArtForEveryDay
WickItCandles: MantisDesign, DoubleJRusticWorks, PigeonPoint, ThriftingNifties, PCAShoponline
OnTheBeSide: SuzysJewelryShop, HoopsPlus, PaisleyParkVintage, ViviansCrown, JinxiesBeads
kinkcircuit: shivajiartstudios, AKBworkshop, StudioKQL, RayofSunshineGlass, hereonart
MaddeeLu: Lemonadedaily, MamaPileggi, lacova, OliviaClaireBows, kidsvintage
GlamClams: Emotionless02, MrPaint, kidsvintage, PaisleyParkVintage, MelindasVintage
NachoMamasQuilt: PureLoveCrosses, PandoraStyleCharms, JinxiesBeads, TreasuredGems365, Jewelryliz
ViviansCrown: Insomny, PandoraStyleCharms, MelindasVintage, NeronaStreet, Jewelryliz
ChrissysCache: MAJOECREATIONS, KhlovesLA, ribbonextravaganza, coralnbeads, Frederike11
reckon69: MagicalCase, PandoraStyleCharms, JinxiesBeads, TreasuredGems365, SarahRobertsonShop
NativeCoutureN8V: MamaPileggi, TopTopps, DeadbeatCustoms, kidsvintage, PandoraStyleCharms
DogBakerySupplies: PetsLoveBlingToo, MrPaint, JoDonJewelry, PandoraStyleCharms, JinxiesBeads
AshleyClarkeFineArt: Farelamore, backintimeart, StudioKQL, hereonart, RayofSunshineGlass
OwlAboutU: LeChapelle, ClemsCards, ArtShoppeCrafts, FlowerStudio13, PhotosbyMM
GalaxyShirts: EllePrelleDesigns, LulabellesEmbroidery, GlamNGrace, HandPaintedTees, DMMonogramming
LanaArta: BrightFlowerHeadband, GlitteryBugz, BlueRibbonBling, Chloescheerbows, ChasingSif
TheFireDojo: MrPaint, PandoraStyleCharms, JinxiesBeads, TreasuredGems365, JoDonJewelry
PureLoveCrosses: GreatGiftsToGo, PandoraStyleCharms, JinxiesBeads, TreasuredGems365, Jewelryliz
kleepstudio: BigRedArts, WordPouch, FuwafuwaKuma, MeganAngelDesign, laurenmtrump
CutPasteScrap: SerenitysWay, JGHandcraftedCards, ClemsCards, KnotThatNautical, MadeWithMarzipan
RoxieJohnB: MichellesNYC, MikaylasBooks, LovinHateStreet, FayesFabFinds, TRINKETSandTREASURE1
KattySwan: PureLoveCrosses, PandoraStyleCharms, JinxiesBeads, TreasuredGems365, JoDonJewelry
RoseysBoutique: CammieCouture, FrediaCreations, kidsvintage, SunshynesKiddyCloset, PandoraStyleCharms
bathsalts4lyfe: kidsvintage, PandoraStyleCharms, MelindasVintage, Emotionless02, MrPaint
EnvelopedElegance: ClemsCards, PandoraStyleCharms, JinxiesBeads, TreasuredGems365, Jewelryliz
DemoreDecorAndMore: MasksAndProps, WithLoveByV, TeddyBeartique, VintageWinery, LabiosDeMel
AFreeForAll: BlackbirdSecrets, MrPaint, WeeWhimzyWardrobe, PandoraStyleCharms, JinxiesBeads
shortsbb: duckyDenim, misterlisters, MamaPileggi, LeChateauWoods, BellaVitaDesignsYona
SuzzieBee: DomesticMcgyver, AFirstEdition, faboandme, TheresaNPieces, MakeThingsPretty
DiversityByCookie: PandoraStyleCharms, JinxiesBeads, TreasuredGems365, Jewelryliz, MelindasVintage
emilygraceclothing: MamaPileggi, DeadbeatCustoms, kidsvintage, PandoraStyleCharms, JinxiesBeads
EssentiaPhotography: JaimeKupfner, SweetSerendipityCaps, DigitalDesignz1, 3LittleCatsDesign, GreatGiftsToGo
IGPhoto: DavidBoydJrFineArt, PhotosbyMM, PandoraStyleCharms, JinxiesBeads, TreasuredGems365
GirlyDazeFactory: nanavolsky, SweetCupCrafts, YleCreations, FreshwatersScents, Dark1art
Sofiwatson: MedfordandBrooke, SewSweetTots, StillTreasured, MamaPileggi, misterlisters
BurrowingBeagleQuilt: atroveoftreasures, Rhubarbandcustardtoo, TheDandyLionRoar, RagTagCountryCrafts, PiperDeveighDesigns
Bestgreenstore: MrPaint, JoDonJewelry, PandoraStyleCharms, JinxiesBeads, TreasuredGems365
SunnBunnie: EidahLovesYou, KellBellsCreations, Tatyanachka, RagBabyDesigns13, Chloescheerbows
LilyandDora: PetsLoveBlingToo, PandoraStyleCharms, JinxiesBeads, TreasuredGems365, JoDonJewelry
SnicketsSnippets: PandoraStyleCharms, JinxiesBeads, TreasuredGems365, Jewelryliz, JoDonJewelry
OhlalaPretties: lacova, JollyAccessories, OliviaClaireBows, PrimPrincess27, ArtsyiPhoneCases
LandLaccess: PandoraStyleCharms, JinxiesBeads, TreasuredGems365, Jewelryliz, MelindasVintage
ComputeroutletZeist: MantisDesign, HaileyPoo, DomesticMcgyver, ThriftingNifties, LocalLivingSA
IzziesAttic: GreatValues, ThePaisleyPuppy, MakeThingsPretty, barndoorantiques, LittlePollyPockets
StaggsCreations: OnTheBeSide, SuzysJewelryShop, HoopsPlus, SeaGlassByKennette, PaisleyParkVintage
ArtsyVeronica: PandoraStyleCharms, JinxiesBeads, TreasuredGems365, JoDonJewelry, Jewelryliz
MPanthFineArt: ArtzMeCrazy, MetalMadeArt, SweetPeaBoogie, Flintsworld, SuelyneeHo
ShoppingInParis: CraftingEssentials, PandoraStyleCharms, JinxiesBeads, TreasuredGems365, Jewelryliz
GreatValues: MelindasVintage, PandoraStyleCharms, kidsvintage, Emotionless02, JinxiesBeads
CraftingEssentials: PandoraStyleCharms, JinxiesBeads, TreasuredGems365, Jewelryliz, MelindasVintage
AllStarrJewels: JAPcreations, EarringsByJane, HomeFeathers, HappyHippyCrafts, MMsJewelry
TheDioceseCollection: TinkieTies, DIGDIN6, AzMtnBlue, CrystalCoutureDesign, MamaPileggi
Mamlouk: ThriftingNifties, MrPaint, SuelyneeHo, LottiesVintageAttic, KidsChairs
Woolartruna: PurpleDotty, BlackbirdSecrets, MrPaint, HandmadebyPurplePopp, barndoorantiques
BubbleBisous: MrPaint, Sew4Generations, NULABA, JoDonJewelry, PandoraStyleCharms
faboandme: MakeThingsPretty, MileHillAntiques, DeadbeatCustoms, silvertime925, GreatValues
CrystalCoutureDesign: DIGDIN6, AzMtnBlue, HandPaintedTees, MamaPileggi, misterlisters
WizardingWares: MrPaint, PandoraStyleCharms, JinxiesBeads, TreasuredGems365, JoDonJewelry
SewSolutions: SewSweetTots, PandoraStyleCharms, JinxiesBeads, TreasuredGems365, kidsvintage
VetGirlsCreations: SuzysJewelryShop, OnTheBeSide, HoopsPlus, MMsJewelry, Teresafashioncorner
VanitosamenteBijoux: Teresafashioncorner, ViviansCrown, LoveBraceletsByAna, Insomny, OnTheBeSide
MountainRagz: PandoraStyleCharms, JinxiesBeads, TreasuredGems365, JoDonJewelry, Jewelryliz
HaileyPoo: SweetTeaNme, nicebabycrochet, KCsStudio44, LocalLivingSA, CammieCouture
Inbinzoo: BohoJunkie, PearlyArtlondon, SweetPeaBoogie, Flintsworld, BOMBcutz
BlowawishBags: MrPaint, PandoraStyleCharms, JinxiesBeads, TreasuredGems365, JoDonJewelry
VintageMemoryShop: MrPaint, MelindasVintage, RyanTokoku, PandoraStyleCharms, junjieshop
DavidBoydJrFineArt: LotusCards, WalkinsWelcome, RayofSunshineGlass, PandoraStyleCharms, JinxiesBeads
EfenCase: JokoCase, ManaCase, SenoCase, CandraCase, JarwoCase
RestlessApparel: DIGDIN6, AzMtnBlue, MamaPileggi, PurpleDotty, kidsvintage
Beatiesvintage: Igulim, JillsMakings, MrPaint, ChansCrochetCreation, WithloveKaty
CitySeamsHandbags: LovelyClassyFinds, PandoraStyleCharms, JinxiesBeads, TreasuredGems365, Jewelryliz
VictorCirone: EarlsGrayTee, MAJOECREATIONS, ribbonextravaganza, coralnbeads, Frederike11
HannahsBracelets: JJHut, ParacordPatriot, CALIHustle, KajunsCrafts, Acmeproducts
SIXTWENTYTWOEIGHTY: JenGrace57, AksesuhrizHOME, ArtbyElizabethK, ArtByAmaris, TheCanvasCorner
GitLit: TheresaNPieces, PandoraStyleCharms, JinxiesBeads, TreasuredGems365, JoDonJewelry
SDEtrading: HouksWoodworks, GoodWood55, Back40SignzTexas, Ducky333, KustomIdeas
ToteAmour: kidsvintage, CammieCouture, OliviaClaireBows, SewSweetTots, PandoraStyleCharms
ZebulonsArmory: PandoraStyleCharms, casesinstyle, MelindasVintage, JinxiesBeads, TreasuredGems365
PurePrintsPhoto: CHCVProductions, LotusCards, WalkinsWelcome, IridescentPhotos, EtherealPix
Prehistorics: LavantaCoffee, PandoraStyleCharms, JinxiesBeads, TreasuredGems365, Jewelryliz
NazarethStore: EgyptKoldKollection, MrPaint, AuburnEmporium, Lovile, SoftsidedJewelry
JewelryAccessoreis: BohemDreams, MrPaint, CynTungFong, JoDonJewelry, AKECreations
JUMBOkitten: laurenmtrump, LivingSpiritDesign, HelloClaireFashion, progressiveprint, TheLadyAgnesShoppe
ExoticLotusJewelry: JoDonJewelry, NovaSingularities, TreasuredGems365, JinxiesBeads, PandoraStyleCharms
PibbleWibbleWear: classyzombie, barndoorantiques, HandmadebyPurplePopp, EllePrelleDesigns, LulabellesEmbroidery
KarateUp: DonnaMaggioDesigns, ZumbaFashions, FanBingBing, TeaseCouture, DMMonogramming
ArtByMuns: depressivepaintings, PaintingsforPJ, junjieshop, JeromeMcDonaldArt, CraftyLeaves
CoocooTutusbyLilz: MamaPileggi, kidsvintage, misterlisters, PandoraStyleCharms, JinxiesBeads
MyRePurposedlifeshop: JaimeBouteilles, Hoctavius, HadleyTable, Decorrencia, Anitahafner
Madefouryou: SerenitysWay, EnvelopedElegance, ClemsCards, JGHandcraftedCards, MadeWithMarzipan
ClickBoxPrints: StudioKQL, CreativeArtByJMintze, JLImagery, JeromeMcDonaldArt, PhotosbyMM
aplauso: Emotionless02, LovelyClassyFinds, jomannjewels, PaisleyParkVintage, kidsvintage
AcornParty: GoodeCatchDesign, SheebeezAccessories, Lovile, SoftsidedJewelry, VanebulaPins
GreeneVintage: Ecohippychic, Malamutemax, jomannjewels, Emotionless02, ThriftingNifties
ManuFest: TiggyandMoggy, AtlantaCityBuilders, GoodWood55, KustomIdeas, Ducky333
ZNaturalzLLC: GoodWood55, KustomIdeas, Ducky333, ingrainedwoods2, Ringo2011
IRONCRAFTfr32: SuelyneeHo, Sporkions, MrPaint, ArtPendant, PandoraStyleCharms
BowsBlingSupply: Frederike11, ribbonextravaganza, coralnbeads, AvaBelleBoutique, dummymummyuk
ClipsAndStuff: MadeByTheRedHead, PillowGroomers, OliviasLoops, CraftsByDre, petalsbymelissa
Craftsbyfitkittymama: PandoraStyleCharms, JinxiesBeads, TreasuredGems365, JoDonJewelry, Jewelryliz
MagnetProjetsbyIGR: StinkyStickers, ShizzlerMtG, TheThingsTheyCarried, pinkllamaprint, hereonart
WireWrappingPassion: Hoctavius, MMsJewelry, MrPaint, PaisleyParkVintage, HoopsPlus
StoryboardFurniture: Ducky333, ingrainedwoods2, Ringo2011, PCAShoponline, PeculiarPens
onelovelyunicorn: MrPaint, CammieCouture, JoDonJewelry, NULABA, PandoraStyleCharms
MarysBowtique: OhlalaPretties, lacova, OliviaClaireBows, ArtsyiPhoneCases, FeltBabyDesign
NotFadeAwayJewelry: OnTheBeSide, SuzysJewelryShop, HoopsPlus, PaisleyParkVintage, JoDonJewelry
Glittergalley: Shavingwood, meryprovi, SparklingDezign, BlazinBeader, EllesHealing
Martinscupboard: PigeonPoint, MrPaint, jomannjewels, ThriftingNifties, PartyFlask
TinkerTotsToyShop: NattysRandomStuff, VanebulaPins, MrPaint, ChasingSif, ArtsyiPhoneCases
Mapify: TristanTannerDesigns, StateofHappiness, allieandann, pinkllamaprint, WasteYrPrints
Indianparadise: PandoraStyleCharms, JinxiesBeads, TreasuredGems365, LocalLivingSA, Jewelryliz
ChocoLolliShop: SweetBeeBaskets, TasteWales, MuseDeFrance, SweetBitesRichmond, JoDonJewelry
ArazziContemporanei: HomeSlab, PigeonPoint, AllThatGlittersHC, TheThingsTheyCarried, hereonart
DoubleDippedMustache: YleCreations, MrPaint, PandoraStyleCharms, JinxiesBeads, TreasuredGems365
RoyalTendency: EllieAtMaluno, serendipitypillows, DeadbeatCustoms, BellatiqueFabrics, StylePowerShop
FromAdriennesHand: MMsJewelry, PaisleyParkVintage, FarahLarki, ViviansCrown, LetsTalkTagua
GlowieMonsters: lovenikkih, StuffandStuffies, PlushieBallerinas, KhlovesLA, KittenSlacks
KaleidoSoapCompany: SudzbyStudz, MrPaint, PandoraStyleCharms, JinxiesBeads, TreasuredGems365
Katyleach: GetKandied, 7on5, pyramidboutique, VioletSeason, CaseOutfitters
TheTeaTimeAsylum: DonnaMaggioDesigns, ZumbaFashions, TeaseCouture, 60sStore, DMMonogramming
GoldieLocksBears: MrPaint, JoDonJewelry, PandoraStyleCharms, JinxiesBeads, TreasuredGems365
SplatterboxDesigns: MrPaint, ClemsCards, PandoraStyleCharms, JinxiesBeads, TreasuredGems365
BlueCloudKnits: PandoraStyleCharms, JinxiesBeads, TreasuredGems365, Jewelryliz, JoDonJewelry
ShaveReady: jomannjewels, Emotionless02, PaisleyParkVintage, kidsvintage, LovelyClassyFinds
Jacksembroidery: Inspiredbyababy, FrediaCreations, CammieCouture, kidsvintage, PandoraStyleCharms
WeCanDraw: backintimeart, RayofSunshineGlass, PandoraStyleCharms, JinxiesBeads, TreasuredGems365
AnnagramCards: ClemsCards, JGHandcraftedCards, JoDonJewelry, PandoraStyleCharms, JinxiesBeads
DearestDaisyUK: PandoraStyleCharms, JinxiesBeads, TreasuredGems365, Jewelryliz, JoDonJewelry
MochiAmigurumi: LittlePollyPockets, MrPaint, PandoraStyleCharms, JinxiesBeads, TreasuredGems365
LaurRitch: ArtShoppeCrafts, FlowerStudio13, LabiosDeMel, VintageWinery, PictureYourSeat
CharmeBeachwear: PandoraStyleCharms, JinxiesBeads, TreasuredGems365, Jewelryliz, JoDonJewelry
DesignsbyKV: PosterJo, ShockCreative, BOMBcutz, MrPaint, RayofSunshineGlass
CreaDoortje: JenGrace57, SIXTWENTYTWOEIGHTY, AksesuhrizHOME, ArtbyElizabethK, ArtByAmaris
CraftAbility4You: JumpingJackalope, ReformedMetals, SweetCanvasDesigns2, ModernCntry, CovertMeiborations
WildHartsclothing: shortsbb, duckyDenim, misterlisters, MamaPileggi, LeChateauWoods
CarCrystalRainbows: SellingRainbows, FrannysBridalHangers, crystalillumination, KattySwan, DivineDangles
JRyanCollection: GoodWood55, KustomIdeas, LottiesVintageAttic, Ducky333, TiggyandMoggy
beautynpizzazz: jesske000, Izzabellas, PigeonPoint, AnticqueShop, PCAShoponline
TikiLimeTreasures: TeaseCouture, DMMonogramming, YorktownCrafts, EtchGear, NULABA
Gluttonous: StudioKQL, CreativeArtByJMintze, PhotosbyMM, RayofSunshineGlass, MrPaint
WillaHowellBullock: KulliMaslova, DimensionZero, WasteYrPrints, TopTopps, MrPaint
CollegePrep: ClemsCards, SerenitysWay, JGHandcraftedCards, MadeWithMarzipan, TheSnarkade
IndyParacord: PureLoveCrosses, GreatGiftsToGo, LavantaCoffee, MrPaint, PandoraStyleCharms
TalisCharms: LoveDNA, MrPaint, GreatGiftsToGo, PureLoveCrosses, OliviasLoops
monmoniko3: Lovile, Trailblazer28, EllesHealing, SoftsidedJewelry, SparklingDezign
2sistersgarden: Sunjoinery, AmericanLandWP, MrPaint, ABoxInTheBasement, CourageousCats
dolliesforfroggies: PigeonPoint, MantisDesign, ThriftingNifties, jesske000, beautynpizzazz
CraftsByDre: OliviasLoops, GreatGiftsToGo, PureLoveCrosses, PandoraStyleCharms, DigitalDesignz1
ShuiShui: MamaPileggi, kidsvintage, Emotionless02, SewSweetTots, MelindasVintage
VictoryChains: BubblingSugar, PartyFlask, aDORYble, AllStarrJewels, JAPcreations
GingerandWaldo: OHBracelets, UnderTheMysticTree, SheebeezAccessories, NovaSingularities, ViviansCrown
ZhannaArt: TheCritterArtist, DogandPetPaintings, FranchaCavitt, MrPaint, RayofSunshineGlass
LeGrenierDeChloe: Ecohippychic, CraftingEssentials, PandoraStyleCharms, JinxiesBeads, TreasuredGems365
MyPaperCraze: ClemsCards, JGHandcraftedCards, MrPaint, RachiPrints, TwoGuysWed
MyDoorToYourDoor: PCAShoponline, PandoraStyleCharms, JinxiesBeads, TreasuredGems365, JoDonJewelry
ArtByAmaris: ArtbyElizabethK, kinkcircuit, TheCanvasCorner, shivajiartstudios, AKBworkshop
alittlehopedesigns: SerenitysWay, ClemsCards, JGHandcraftedCards, AllieAnnsAttic, KnotThatNautical
pyramidboutique: GetKandied, 7on5, ABoxInTheBasement, VioletSeason, CourageousCats
QueenieShop: KnotKnitShop, LegoMarket, elementofwonder, classyzombie, GlamClams
DesignsPS: YuliaCards, JGHandcraftedCards, KnotThatNautical, ClemsCards, JoDonJewelry
LadyBirdesign: PandoraStyleCharms, JinxiesBeads, TreasuredGems365, Jewelryliz, MelindasVintage
Helsmart: serendipitypillows, BellatiqueFabrics, NULABA, B16Design, KARYMUSA
lukamilaswood: ArtallaBCN, LovelyAdmirations, ParacordPatriot, CALIHustle, KajunsCrafts
CherryPinkDiamond: TribalTees, ThreadbareLab, WyldeBrambleEmporium, TopTopps, BellaVitaDesignsYona
KnittynNice: KnitKnackNotions, WoollyDelight, PurpleDotty, Frederike11, serendipitypillows
SurvivorGirls: CALIHustle, KajunsCrafts, ParacordPatriot, Acmeproducts, Waggonerra1
HoneyTutus: Beesafe, FishGirlFashions, HandPaintedTees, DIGDIN6, AzMtnBlue
SnowflakeCollections: FashionbyOlga, NotGREY, DMaxArt, canvasanni, GuiltyPleasureINK
WoollyDelight: SweetTeaNme, nicebabycrochet, ChansCrochetCreation, CraftingEssentials, KCsStudio44
KillinTimeCrafting: RagBabyDesigns13, JoDonJewelry, SoftsidedJewelry, Lovile, NovaSingularities
TheAwkwardPenguin: EllePrelleDesigns, LulabellesEmbroidery, GlamNGrace, HandPaintedTees, DMMonogramming
CalmSurrender: FanBingBing, DragonflyTease, misterlisters, PrimPrincess27, EADHandmade
SpeakerBlock: MrPaint, PandoraStyleCharms, JinxiesBeads, TreasuredGems365, JoDonJewelry
fashioncomesfirst: Insomny, ViviansCrown, Lovile, OHBracelets, SheebeezAccessories
DisegnoStudio: MagicalCase, PandoraStyleCharms, JinxiesBeads, TreasuredGems365, casesinstyle
PainterParragi: Natasha354, KulliMaslova, LLarabeeStudio, MikeHaroArt, DMaxArt
soniahalejak: barndoorantiques, HandmadebyPurplePopp, TheresaNPieces, MMsJewelry, JoDonJewelry
GreatGiftsToGo: PureLoveCrosses, PandoraStyleCharms, JinxiesBeads, TreasuredGems365, Jewelryliz
pinkllamaprint: WasteYrPrints, hereonart, TheThingsTheyCarried, TheLadyAgnesShoppe, RayofSunshineGlass
GabesSprayPaintArt: hereonart, RayofSunshineGlass, StudioKQL, PandoraStyleCharms, JinxiesBeads
CoverMeCovers: CammieCouture, OliviaClaireBows, kidsvintage, lacova, SewSweetTots
CostumeGetsCrafty: TinyTrack, KathyLizBoutique, MrPaint, LovelyClassyFinds, SimplyElegantFemme
IPcase: PandoraStyleCharms, JinxiesBeads, TreasuredGems365, TheLadyAgnesShoppe, RayofSunshineGlass
SouthernStash: MantisDesign, DoubleJRusticWorks, PigeonPoint, OllieandMrBear, StinkyStickers
pmz2HasStuff4U: FurryGraphicDesign, JaggedLittlePill42, MagnoliaStation, ribbonextravaganza, coralnbeads
GeekChicBowtique: PandoraStyleCharms, JinxiesBeads, TreasuredGems365, Jewelryliz, casesinstyle
BohemDreams: LoveBraceletsByAna, Teresafashioncorner, Insomny, SeaGlassByKennette, ViviansCrown
TenButterFingers: KitchenKovers, CakedayAU, MrPaint, lacova, OliviaClaireBows
ModernCntry: CharmeBeachwear, KeynoteCollectibles, Malamutemax, kidsvintage, MamaPileggi
kimbrenasdesigns: WasteYrPrints, SouthernBlessings002, TheLadyAgnesShoppe, OhSoPrintableDesigns, OfficialWondercraft
MartinLynchSmith: TheLadyAgnesShoppe, SouthernBlessings002, JamiesDoodles, WasteYrPrints, MrPaint
BBShore: Emotionless02, SANTAFELEATHER, LadyBirdesign, kidsvintage, MrPaint
MileHillAntiques: GreatValues, jomannjewels, Emotionless02, NewandOldGifts, MakeThingsPretty
Courtelisedesigns: backintimeart, PandoraStyleCharms, JinxiesBeads, TreasuredGems365, RayofSunshineGlass
LaughterStone: MAJOECREATIONS, ribbonextravaganza, coralnbeads, Frederike11, dummymummyuk
CreativeDesignsbySWC: TreasuredGems365, JinxiesBeads, PandoraStyleCharms, JoDonJewelry, Jewelryliz
LucidStitches: SweetTeaNme, copperscrafts, HaileyPoo, nicebabycrochet, ParacordPatriot
Farelamore: CHCVProductions, MikeHaroArt, StudioKQL, GabesSprayPaintArt, SouthernBlessings002
MegFranBands: PandoraStyleCharms, JinxiesBeads, TreasuredGems365, Jewelryliz, MelindasVintage
Debee333: darebefun, HappyHippyCrafts, MamaRavens, TheAcornFairy, WonderWomanz
RingsmuthWelding: SteveSimpsonShop, LolaMontejo, FeyMosacis, PauzaDamascusArt, DemoRSShop
MuggleMadeCreations: ClemsCards, PandoraStyleCharms, JinxiesBeads, TreasuredGems365, Jewelryliz
WFPstudios: StudioKQL, PhotosbyMM, CreativeArtByJMintze, MrPaint, RayofSunshineGlass
WerdBird: FarahLarki, JinxiesBeads, TreasuredGems365, LetsTalkTagua, Jewelryliz
MuktaCrafts: JJHut, PamiesPatterns, UnderTheMysticTree, SheebeezAccessories, funjewls4u
TiffaniCrafts: JinxiesBeads, TreasuredGems365, Jewelryliz, NeronaStreet, JoDonJewelry
SouthernBeautySkin: PandoraStyleCharms, JinxiesBeads, TreasuredGems365, Jewelryliz, JoDonJewelry
RingPen: ingrainedwoods2, PeculiarPens, Ducky333, PCAShoponline, MrPaint
DriaBabyBoutique: Jacksembroidery, CammieCouture, MrPaint, FrediaCreations, kidsvintage
Buoncachete: MrPaint, PoeFamilyJewels, SarahRobertsonShop, SparklingDezign, BlazinBeader
LillykinsCrafts: SheekBurlapDesigns, TissuesandTulipsTwo, MrPaint, VarmCountry, PCAShoponline
LuckygirlBling: PamiesPatterns, UnderTheMysticTree, SheebeezAccessories, funjewls4u, OHBracelets
MissTreated: Farelamore, TheThingsTheyCarried, StudioKQL, hereonart, RayofSunshineGlass
LunarDragons: jvsDesign, CristysCorner, DragonflyTease, AllStarrJewels, JAPcreations
GemmaHedgie: SuzysJewelryShop, OnTheBeSide, DangleMeEarrings, HoopsPlus, SeaGlassByKennette
HoshiTae: TheCanvasCorner, Courtelisedesigns, WeCanDraw, backintimeart, laurenmtrump
DamnitDolls: WeeWhimzyWardrobe, JoDonJewelry, PandoraStyleCharms, JinxiesBeads, TreasuredGems365
FloralPainting: SteveSimpsonShop, LolaMontejo, RingsmuthWelding, FeyMosacis, PauzaDamascusArt
SewManx: lovenikkih, StuffandStuffies, WeeWhimzyWardrobe, CoCoMichelles, FeltBabyDesign
HugsCreations: DomesticMcgyver, AFirstEdition, MantisDesign, faboandme, MakeThingsPretty
hoolitshoose: PeculiarPens, MrPaint, PCAShoponline, StephenWiseDesign, ingrainedwoods2
SASBeautyCloset: CitySeamsHandbags, LeChateauWoods, jomannjewels, Emotionless02, LovelyClassyFinds
CHUCHULove: MENTOSDRIVE, SANTAFELEATHER, LadyBirdesign, MrPaint, PandoraStyleCharms
SomethingBeautiful19: JoDonJewelry, NovaSingularities, TreasuredGems365, JinxiesBeads, Jewelryliz
SparkleAndCharming: FrediaCreations, MamaPileggi, kidsvintage, CammieCouture, BeatriceBent
OllieandMrBear: PandoraStyleCharms, PCAShoponline, JinxiesBeads, TreasuredGems365, TissuesandTulipsTwo
AlotusArt: maryannevansart, pinkllamaprint, WasteYrPrints, TristanTannerDesigns, KvoFolkArt
UkuleleBreeze: TheThingsTheyCarried, hereonart, RayofSunshineGlass, pinkllamaprint, PhotosbyMM
AutumnLeavesShop: Ecohippychic, CindyliciousEmporia, LeGrenierDeChloe, TribalTees, CraftingEssentials
PixelArtPost: PandoraStyleCharms, JinxiesBeads, TreasuredGems365, Jewelryliz, MelindasVintage
junjieshop: JinxiesBeads, TreasuredGems365, JoDonJewelry, PandoraStyleCharms, Jewelryliz
VioletSeason: SarahRobertsonShop, RyanTokoku, MagicalCase, reckon69, casesinstyle
SUBCONSCIOUSCANVAS: StudioKQL, CreativeArtByJMintze, MrPaint, PhotosbyMM, GabesSprayPaintArt
madewithlovebyjennie: AnnaKnittingShop, BonnieBGOODS, HelloClaireFashion, YorktownCrafts, lakeandtower
TheOddsShop: BeatriceBent, LeChapelle, AlwaysRoomforJello, NaturesHardwear, Inspiredbyababy
Got2HaveNow: CALIHustle, KajunsCrafts, ParacordPatriot, Acmeproducts, Waggonerra1
WishyWashAcc: Shavingwood, meryprovi, SparklingDezign, BlazinBeader, EllesHealing
Thersart: SouthernBlessings002, WeCanDraw, Lithographia, TheThingsTheyCarried, TheCanvasCorner
KARYMUSA: NULABA, ArtsyiPhoneCases, JollyAccessories, PandoraStyleCharms, JinxiesBeads
YarnOverGame: SweetTeaNme, HaileyPoo, nicebabycrochet, ChansCrochetCreation, serendipitypillows
LightAffair: FedwellFarm, ZYOENTERTAINMENT, AlissaBrunelliPhoto, CHCVProductions, LotusCards
HandDrawnLithographs: DoubleJRusticWorks, MrPaint, Michaelajayneart, IridescentPhotos, HelloClaireFashion
GalaxyBoutique: GreatValues, MileHillAntiques, MelindasVintage, PandoraStyleCharms, kidsvintage
Supertogether: MagicalCase, PandoraStyleCharms, JinxiesBeads, TreasuredGems365, Jewelryliz
TomLonkaPhotography: WalkinsWelcome, LotusCards, DeSooza, GabesSprayPaintArt, PhotosbyMM
MommaHouseofO: SistersWreaths, MyDoorToYourDoor, MantisDesign, DodieGray, SheekBurlapDesigns
WoodnLightLamps: moodd, GreatValues, LocalLivingSA, KCsStudio44, CammieCouture
1985Store: HoughtonsHouses, Craftsbyfitkittymama, WarmFeelings, WithloveKaty, DerStickbaer
RoxfordOriginals: OMGLocketsandcharms, SheebeezAccessories, Tinasuniquedesigns, Lovile, Trailblazer28
ScottAllenPaintings: TheCritterArtist, FranchaCavitt, EvaSzorcFineArt, DogandPetPaintings, KulliMaslova
Machlev: ChristopherOakden, billjamespainting, FedwellFarm, BellaVitaDesignsYona, GabesSprayPaintArt
HoopsPlus: MMsJewelry, PaisleyParkVintage, ViviansCrown, JoDonJewelry, TreasuredGems365
BenBigelowStudio: SweetPeaBoogie, Flintsworld, ZYOENTERTAINMENT, PosterJo, ShockCreative
BitofOrange: BodyOcea, KillinTimeCrafting, TheLavenderFarmShop, Jacksembroidery, PhotosbyMM
CarnEntralCakes: BELLSBARKERY, CampusBakes, TasteWales, ChrismanCreations, SukkerogSmor
DIGDIN6: AzMtnBlue, CrystalCoutureDesign, MamaPileggi, HandPaintedTees, misterlisters
LeChapelle: BeatriceBent, PandoraStyleCharms, JinxiesBeads, TreasuredGems365, Jewelryliz
mememarket: MrPaint, FrediaCreations, CammieCouture, JoDonJewelry, SoftsidedJewelry
Rhubarbandcustardtoo: fowlkesmazyck, NaturesHardwear, AshNicoleCreations, NULABA, FrediaCreations
LapisLazuliWorld: Anitahafner, OrgonizeYourLife, ArtPendant, NeronaStreet, JoDonJewelry
VINtageVShandMade: COLOURLENSES, ThreadbareLab, WyldeBrambleEmporium, YorktownCrafts, BellaVitaDesignsYona
FeysFairies: deasycrafter, petalsbymelissa, MadeByTheRedHead, PillowGroomers, OliviasLoops
BCStudioDesigns: LocalLivingSA, PandoraStyleCharms, JinxiesBeads, TreasuredGems365, Jewelryliz
StitchWitchKate: CrossRoman, KasiaWorks, finitestitches, UfairaCraft, Kattugle
ErksandQuirks: TristanTannerDesigns, SouthernBlessings002, kimbrenasdesigns, pinkllamaprint, WasteYrPrints
WoodturningRoss: PeculiarPens, PCAShoponline, PandoraStyleCharms, JinxiesBeads, TreasuredGems365
SweetBitesRichmond: PandoraStyleCharms, JinxiesBeads, TreasuredGems365, Jewelryliz, JoDonJewelry
TwoBrokeGirlsJewelry: WearableSpoons, Insomny, MrPaint, Lovile, ViviansCrown
YonselDunGenre: JoDonJewelry, JinxiesBeads, TreasuredGems365, Jewelryliz, MelindasVintage
NLParacord: metriczinc, VanitosamenteBijoux, ParacordPatriot, JJHut, ExoticLotusJewelry
JaimeKupfner: OliviasLoops, GaSouthernLights, CollsCoveredBoxes, GreatGiftsToGo, PureLoveCrosses
CharzJewelz: YleCreations, Hoctavius, PamiesPatterns, ISLAoak, UnderTheMysticTree
ImagerybyKevin: CHCVProductions, WalkinsWelcome, LotusCards, DavidBoydJrFineArt, TheThingsTheyCarried
amyartworks: JenGrace57, SIXTWENTYTWOEIGHTY, AksesuhrizHOME, ArtbyElizabethK, ArtByAmaris
brocadeusa: ChesterInc, LoveChuckTaylors, SparkleAndCharming, bluemolasses, ImaginedImpressions
ShopRikitik: CraftyLeaves, PaintingsforPJ, depressivepaintings, canvasanni, LocalLivingSA
HouseofSavageLeather: SnicketsSnippets, MrPaint, PandoraStyleCharms, JinxiesBeads, TreasuredGems365
LovingMurals: RingmasterPottery, PaviaLee, MrPaint, JoDonJewelry, PandoraStyleCharms
Nostaljic: SewSweetTots, NULABA, misterlisters, DiversityByCookie, kidsvintage
IvannaN: AtlanteanCreations, MrPaint, AnnaKnittingShop, MamaPileggi, NaturesHardwear
Back40SignzTexas: HouksWoodworks, PeculiarPens, PCAShoponline, ingrainedwoods2, PandoraStyleCharms
PACKtheSTORE: COLOURLENSES, ThreadbareLab, WyldeBrambleEmporium, AlwaysRoomforJello, YorktownCrafts
BeautifulFursbyBella: BonnieBGOODS, SmArtWrApparel, HelloClaireFashion, StephBeeIllustration, AnnaKnittingShop
OnHallowedGround: MelindasVintage, MissionHouse, PaisleyParkVintage, JoDonJewelry, PandoraStyleCharms
flowergrrrrl: shortsbb, duckyDenim, RebelMaKia, DIGDIN6, AzMtnBlue
PetitFoursShop: PandoraStyleCharms, JinxiesBeads, TreasuredGems365, Jewelryliz, MelindasVintage
JewelsbySP: TeaseCouture, EllePrelleDesigns, LulabellesEmbroidery, HandPaintedTees, GlamNGrace
Saraseaart: FishCommander, SuelyneeHo, Sporkions, FunFunkyU, hereonart
BexNest: Hoctavius, pinkllamaprint, TristanTannerDesigns, WasteYrPrints, KvoFolkArt
MumAngel: NeronaStreet, Jewelryliz, JinxiesBeads, TreasuredGems365, JoDonJewelry
RusticRemidies: inmyattictoyours, jesske000, beautynpizzazz, Izzabellas, jomannjewels
AKECreations: PandoraStyleCharms, JinxiesBeads, TreasuredGems365, Jewelryliz, kidsvintage
ohhowcutesigns: shivajiartstudios, kinkcircuit, AKBworkshop, StudioKQL, RayofSunshineGlass
EgyptKoldKollection: HoopsPlus, MMsJewelry, PaisleyParkVintage, ViviansCrown, SoftsidedJewelry
BandEsdesigns: MantisDesign, PCAShoponline, PigeonPoint, PandoraStyleCharms, JinxiesBeads
NattysRandomStuff: ImaginariumShop, Dark1art, BelleAnnDesigns, StinkyStickers, EllePrelleDesigns
DogandPetPaintings: PandoraStyleCharms, JinxiesBeads, TreasuredGems365, Jewelryliz, MelindasVintage
PenSmithDesign: PeculiarPens, PandoraStyleCharms, JinxiesBeads, TreasuredGems365, Jewelryliz
GudrunStitches: LeChateauWoods, PandoraStyleCharms, JinxiesBeads, TreasuredGems365, JoDonJewelry
TimelessVintageClock: MissionHouse, OnHallowedGround, PaisleyParkVintage, jomannjewels, SeaGlassByKennette
AngelsinAttic: CoCoMichelles, BellaVinoArt, MrPaint, BlackbirdSecrets, JoDonJewelry
TheAFFreaks: StillTreasured, SewSweetTots, MagieNoireRo, misterlisters, Emotionless02
SavannahWoodCom: Marjellchens, LottiesVintageAttic, ThriftingNifties, MrPaint, KidsChairs
PillowGroomers: MadeByTheRedHead, petalsbymelissa, OliviasLoops, Hytek3D, GreatGiftsToGo
LittleShopOfBayn: DeadbeatCustoms, StudioKQL, CreativeArtByJMintze, MrPaint, MeanKids
DaneensVintagePics: HiddenDrawerVintage, ShopRikitik, DragonflyTease, misterlisters, jomannjewels
Tu2Cute4You: OliviaClaireBows, kidsvintage, CammieCouture, MrPaint, PandoraStyleCharms
JummyTreats: DesignedbyJB, nitrogeek2012, LottiesVintageAttic, ThriftingNifties, PhotosbyMM
TritonEarth: TristanTannerDesigns, pinkllamaprint, WasteYrPrints, KvoFolkArt, progressiveprint
TheYarnArtStudio: soulfulcollection, MrPaint, BettyFinds, MysteryDealMichelle, copperscrafts
Sweet27Creations: OverTheTopDaiperCake, RosaBlancaBaby, AshNicoleCreations, FrediaCreations, Inspiredbyababy
NaturalbyNature2013: MrPaint, PandoraStyleCharms, JinxiesBeads, JoDonJewelry, TreasuredGems365
TeacupMarket: CraftingEssentials, ShoppingInParis, PandoraStyleCharms, JinxiesBeads, TreasuredGems365
BellaBearCrafts: HaleysHandicrafts, DsquaredCraftyCreati, Viscarfshop, NanasRuffles, CreationsbyCherylO
AvianSmiles: PetsLoveBlingToo, ThePaisleyPuppy, MrPaint, barndoorantiques, MakeThingsPretty
CraftyLeaves: PaintingsforPJ, depressivepaintings, GabesSprayPaintArt, RayofSunshineGlass, hereonart
ChathamSignShop: HouksWoodworks, Back40SignzTexas, NataliesFabArt, ingrainedwoods2, PeculiarPens
PosterJo: PandoraStyleCharms, JinxiesBeads, TreasuredGems365, Jewelryliz, MelindasVintage
LaMolineraRastrillo: paperbagblues, highcraft, TheTechNeck, BsEce, ThriftingNifties
DefiniteArticles: Trailblazer28, funjewls4u, BeastetteWristWraps, SANTAFELEATHER, Lovile
JunkmomsTreasures: Malamutemax, MelindasVintage, PandoraStyleCharms, kidsvintage, Emotionless02
TKCheerBows: DespyVintage, 3GirlsCrafts, RagBabyDesigns13, KellBellsCreations, JollyAccessories
kaithog: Mullicamomsoycandles, CammieCouture, LocalLivingSA, JoDonJewelry, KCsStudio44
FABRICEMABILLOT: CHCVProductions, WalkinsWelcome, TheThingsTheyCarried, LauraInkPhotography, DavidBoydJrFineArt
NaturesMarvels: hereonart, RayofSunshineGlass, FunFunkyU, creabonbon, SweetSugarPixels
StarLoveJewelry: Anitahafner, TreasuredGems365, JinxiesBeads, JoDonJewelry, PandoraStyleCharms
iamdreamingoutloud: DMMonogramming, FanBingBing, MamaPileggi, kidsvintage, JinxiesBeads
CALIHustle: KajunsCrafts, ParacordPatriot, Acmeproducts, Waggonerra1, CreatedfortheCreator
NYGOGO: CrystalCoutureDesign, DIGDIN6, AzMtnBlue, HandPaintedTees, LeChateauWoods
FanCollections: Debee333, darebefun, HappyHippyCrafts, PoeFamilyJewels, MamaRavens
MessySea: JUMBOkitten, progressiveprint, mitchmakesstuff, MyLittleCornerCards, RachiPrints
TheBostonCollection: WalkinsWelcome, GabesSprayPaintArt, DeSooza, LotusCards, StudioKQL
JanelleMoffittimages: LotusCards, EtherealPix, WalkinsWelcome, MrPaint, PhotosbyMM
BlotofLondon: CitySeamsHandbags, B16Design, soulfulcollection, LovelyClassyFinds, MoradoBags
WarriorPrincessGems: Hoctavius, Anitahafner, NeronaStreet, Jewelryliz, JinxiesBeads
FaithShallBeMyEyes: TheCanvasCorner, CakeToppersAndBeyond, MrPaint, JumpingJackalope, PureLoveCrosses
RagBabyDesigns13: OliviaClaireBows, JollyAccessories, SewSweetTots, kidsvintage, ArtsyiPhoneCases
DivesDesign: ChasingSif, ArtsyiPhoneCases, Chloescheerbows, JollyAccessories, OliviaClaireBows
IconicItems: ArtzMeCrazy, MetalMadeArt, SweetPeaBoogie, Flintsworld, SuelyneeHo
Overthemoonbcn: PandoraStyleCharms, JinxiesBeads, TreasuredGems365, Jewelryliz, MelindasVintage
FlowersbySara: LeChapelle, MrPaint, PandoraStyleCharms, JinxiesBeads, TreasuredGems365
Elizabethsstuff: PigeonPoint, MileHillAntiques, MakeThingsPretty, silvertime925, MrsVintageShoppe
11thDimensionDesigns: ArtsyiPhoneCases, hereonart, RayofSunshineGlass, JollyAccessories, PandoraStyleCharms
LuckyShopping777: TreasuredTinys, LittlePollyPockets, MrPaint, PandoraStyleCharms, MelindasVintage
PhotoMagique: IridescentPhotos, OfficialWondercraft, PhotosbyMM, OhSoPrintableDesigns, TheLadyAgnesShoppe
MaddThreads: kidsvintage, CammieCouture, PandoraStyleCharms, JinxiesBeads, TreasuredGems365
SweetTeaNme: nicebabycrochet, HaileyPoo, KCsStudio44, PandoraStyleCharms, JinxiesBeads
HomeFeathers: AllStarrJewels, JAPcreations, EarringsByJane, HappyHippyCrafts, MMsJewelry
MarkMynottImages: WalkinsWelcome, EtherealPix, LotusCards, LauraInkPhotography, ArtForEveryDay
CURTAINLADYDESIGN: SpecialtyTowels, WarmFeelings, HandmadebyPurplePopp, WithloveKaty, BradyWorldDesigns
JWstreasures: MissionHouse, OnHallowedGround, SellingOffMyTreasure, jomannjewels, PaisleyParkVintage
Kellzjewels: Insomny, SheebeezAccessories, ViviansCrown, OHBracelets, PamiesPatterns
Reenesplace: ElizaDaysVintage, SikkFab, misterlisters, StillTreasured, SewSweetTots
lilangelsg2: nicebabycrochet, BeatriceBent, LeChapelle, ChansCrochetCreation, Inspiredbyababy
ChloesCave: CALIHustle, KajunsCrafts, ParacordPatriot, Acmeproducts, Waggonerra1
StephenWiseDesign: PandoraStyleCharms, JinxiesBeads, TreasuredGems365, Jewelryliz, JoDonJewelry
lecoindubois: PeculiarPens, PCAShoponline, Ringo2011, PandoraStyleCharms, JinxiesBeads
MrPaint: PandoraStyleCharms, JinxiesBeads, TreasuredGems365, Jewelryliz, MelindasVintage
JolisJams: ZlitcheStitchez, deasycrafter, GaSouthernLights, CollsCoveredBoxes, OliviasLoops
SparklingDezign: BlazinBeader, MeltingWithLight, moonspecies, SoftsidedJewelry, EllesHealing
AsherLiving: KidsChairs, ThriftingNifties, MrPaint, PandoraStyleCharms, JinxiesBeads
colourpad: RayofSunshineGlass, hereonart, SweetSugarPixels, creabonbon, PandoraStyleCharms
RymmaDesigns: TheThingsTheyCarried, pinkllamaprint, BluePeriodArt, FunFunkyU, hereonart
Anitahafner: JinxiesBeads, TreasuredGems365, PandoraStyleCharms, Jewelryliz, NeronaStreet
KulliMaslova: PandoraStyleCharms, JinxiesBeads, TreasuredGems365, Jewelryliz, MrPaint
TabbyLeotards: DIGDIN6, AzMtnBlue, MamaPileggi, kidsvintage, SewSweetTots
EvaSzorcFineArt: TheCritterArtist, DogandPetPaintings, PandoraStyleCharms, JinxiesBeads, TreasuredGems365
goingandcoming: MagicalCase, PandoraStyleCharms, JinxiesBeads, TreasuredGems365, Jewelryliz
SudzbyStudz: PandoraStyleCharms, JinxiesBeads, TreasuredGems365, Jewelryliz, JoDonJewelry
atelierJOKOart: Sporkions, SuelyneeHo, BekkaBeek, ArtPendant, BsEce
StanSGDesign: Atomic39, TheShapeOfMySpace, 2manos, JaneysThings, RingmasterPottery
TheSwedishGypsy: MrPaint, PandoraStyleCharms, JinxiesBeads, TreasuredGems365, JoDonJewelry
QuiltingBee1020: BellatiqueFabrics, PandoraStyleCharms, JinxiesBeads, TreasuredGems365, CraftingEssentials
jesske000: beautynpizzazz, Izzabellas, PigeonPoint, AnticqueShop, ThriftingNifties
FeyMosacis: SteveSimpsonShop, LolaMontejo, RingsmuthWelding, PauzaDamascusArt, DemoRSShop
AmiDeea: SweetTeaNme, nicebabycrochet, ChansCrochetCreation, LittlePollyPockets, KCsStudio44
CarolinasLittleShop: 2manos, StephenWiseDesign, HinesCustomDesigns, PaviaLee, MrPaint
LoveBraceletsByAna: Teresafashioncorner, PandoraStyleCharms, ViviansCrown, TreasuredGems365, JinxiesBeads
DonnaMaggioDesigns: ZumbaFashions, TeaseCouture, DMMonogramming, ThreadbareLab, WyldeBrambleEmporium
CinnamonhSarah: CatalindaFashion, ChesterInc, LoveChuckTaylors, bluemolasses, MrPaint
MeladStudioWorks: ArtallaBCN, LottiesVintageAttic, LovelyAdmirations, HadleyTable, DpistolS
JLPKBracelets: OHBracelets, UnderTheMysticTree, NovaSingularities, JoDonJewelry, PandoraStyleCharms
WeddinginArcadia: FiestaFancies, VintageWinery, LabiosDeMel, PoppinToppin, ArtShoppeCrafts
MadebyJoUK: HoughtonsHouses, 2manos, Craftsbyfitkittymama, PastTimePickins, PaviaLee
LopesEditionDesign: HoopsPlus, Anitahafner, OrgonizeYourLife, KidsChairs, NeronaStreet
shivajiartstudios: kinkcircuit, AKBworkshop, StudioKQL, RayofSunshineGlass, PandoraStyleCharms
madebyraquel: LeChateauWoods, SweetTeaNme, inmyattictoyours, nicebabycrochet, ChansCrochetCreation
BetsyAndSusy: AlenaBlissYou, KellBellsCreations, OhlalaPretties, LovelyAdmirations, blgirard2451
PartyFiestaProducts: JaimeKupfner, SweetSerendipityCaps, VinylGraphix, 3LittleCatsDesign, DigitalDesignz1
PigeonPoint: ThriftingNifties, GreatValues, jomannjewels, PCAShoponline, Emotionless02
KyleAlexandraStyle: Malamutemax, ModernCntry, PhotosbyMM, JoDonJewelry, PandoraStyleCharms
MrsVintageShoppe: MileHillAntiques, NewandOldGifts, GreatValues, PaisleyParkVintage, Emotionless02
NailArtisan: MrPaint, PandoraStyleCharms, JinxiesBeads, TreasuredGems365, JoDonJewelry
ROejewellery: OrgonizeYourLife, MrPaint, ViviansCrown, PrincessJewelsByCaly, FarahLarki
AtlantaCityBuilders: TiggyandMoggy, GoodWood55, KustomIdeas, Ducky333, ingrainedwoods2
DivineDangles: OHBracelets, UnderTheMysticTree, NovaSingularities, SheebeezAccessories, bylaurab
intuitivescorpio76: GreatGiftsToGo, PureLoveCrosses, DigitalDesignz1, PhotosbyMM, OhSoPrintableDesigns
Miaux: GFbestcase, reckon69, kidsvintage, SarahRobertsonShop, LadyBirdesign
JasoneAnso: Anitahafner, WearableSpoons, FarahLarki, NeronaStreet, Jewelryliz
CreviceFlowers: MelindasVintage, kidsvintage, PandoraStyleCharms, JinxiesBeads, TreasuredGems365
maysminiwonderland: Anitahafner, MrPaint, OrgonizeYourLife, Jewelryliz, JinxiesBeads
LivingLifeCreatively: PandoraStyleCharms, JinxiesBeads, TreasuredGems365, PureLoveCrosses, Jewelryliz
WyldeBrambleEmporium: ThreadbareLab, BellaVitaDesignsYona, TeaseCouture, misterlisters, LeChateauWoods
JohnGoodyear: WindowandWallDesigns, RayofSunshineGlass, hereonart, MrPaint, SweetSugarPixels
HandcraftsSewCute: BlackbirdSecrets, MrPaint, KCsStudio44, PandoraStyleCharms, JinxiesBeads
HighCottonSouthernCo: ClemsCards, JGHandcraftedCards, SerenitysWay, PandoraStyleCharms, JinxiesBeads
Marinercards: SerenitysWay, ClemsCards, JGHandcraftedCards, KnotThatNautical, MadeWithMarzipan
lovenikkih: ModernCntry, LovelyAdmirations, PigeonPoint, LocalLivingSA, JoDonJewelry
ParacordPatriot: PamiesPatterns, funjewls4u, Insomny, Lovile, ViviansCrown
MegDeLiseDesigns: LanieBee, CoocooTutusbyLilz, CulmandsHandmadeGift, SatinSouthernFlare, PinkSatinSecrets
KajunsCrafts: CALIHustle, ParacordPatriot, Acmeproducts, Waggonerra1, CreatedfortheCreator
PatternsandFabric: Ecohippychic, LeGrenierDeChloe, CindyliciousEmporia, Frederike11, ribbonextravaganza
BashsToyBoxes: ThriftingNifties, CammieCouture, OliviaClaireBows, kidsvintage, lacova
Abrilanne: SuzysJewelryShop, OnTheBeSide, highcraft, HoopsPlus, MMsJewelry
CandGjewelry: OHBracelets, UnderTheMysticTree, NovaSingularities, SheebeezAccessories, ViviansCrown
JulieSurvivalBands: BeastetteWristWraps, SANTAFELEATHER, DeadbeatCustoms, StylePowerShop, MrPaint
morvorenbags: CitySeamsHandbags, Tekmates, LovelyClassyFinds, PureLoveCrosses, PandoraStyleCharms
LoveJustPlainVintage: StillTreasured, misterlisters, LeChateauWoods, SewSweetTots, MamaPileggi
Tinasuniquedesigns: Trailblazer28, JoDonJewelry, SoftsidedJewelry, Lovile, NovaSingularities
AliceInGraphicLand: ArtShoppeCrafts, FlowerStudio13, LeChapelle, LabiosDeMel, ONLY1NICOLE
HeavySeas: RufioPortraits, backintimeart, WeCanDraw, MrPaint, BOMBcutz
00VintageGlaze00: nanavolsky, YleCreations, Dark1art, SweetCupCrafts, LanntheClever
MollyMooCrafts: Clairvoyantmedium, JumpingJackalope, ModernCntry, LovelyAdmirations, MrPaint
JLImagery: PandoraStyleCharms, JinxiesBeads, TreasuredGems365, Jewelryliz, LotusCards
ArtSketches: AshleyClarkeFineArt, WeCanDraw, Paulax77, backintimeart, SouthernBlessings002
BigMommasDoor: SheekBurlapDesigns, TissuesandTulipsTwo, MrPaint, VarmCountry, PandoraStyleCharms
Gypsyluxevintage: JaneysThings, KeynoteCollectibles, jesske000, beautynpizzazz, ModernCntry
FortheLoveofsoapCO: MilkRiverBathBody, MrPaint, SudzbyStudz, PandoraStyleCharms, JinxiesBeads
Alyxsthriftyboutique: Emotionless02, MelindasVintage, kidsvintage, PandoraStyleCharms, PaisleyParkVintage
HelloFootface: DomesticMcgyver, TheresaNPieces, AFirstEdition, MakeThingsPretty, MMsJewelry
ALDTarot: KattySwan, OliviasLoops, GaSouthernLights, CollsCoveredBoxes, GreatGiftsToGo
ClassiClutch: PandoraStyleCharms, JinxiesBeads, TreasuredGems365, Jewelryliz, MelindasVintage
QuirkyHairBows: littleBOWSdelivery, KellBellsCreations, SheIsSewVegan, SugarDame, RagBabyDesigns13
Crochetfrogpouch: Creativebags28, copperscrafts, Tekmates, SweetTeaNme, TiffaniCrafts
DoorCountyCreations: TimothyLandes, StephenWiseDesign, MrPaint, HinesCustomDesigns, PaviaLee
Theoldeprimfarmhouse: HouksWoodworks, ChathamSignShop, Back40SignzTexas, NataliesFabArt, Cloud9Devine
MyOrganizedLife: PinOnArt, AllieAnnsAttic, alittlehopedesigns, HighCottonSouthernCo, TotallyWrappedUp
CarlosRFineArt: ArtOfKenneth, MrPaint, StudioKQL, backintimeart, PhotosbyMM
JJCrystalinewings: PinkSatinSecrets, PurpleDotty, WeeWhimzyWardrobe, CoCoMichelles, BlackbirdSecrets
SmashedCopper: WearableSpoons, SoftsidedJewelry, Lovile, JoDonJewelry, NeronaStreet
TheLadyAgnesShoppe: LivingSpiritDesign, RayofSunshineGlass, PandoraStyleCharms, JinxiesBeads, TreasuredGems365
WindowandWallDesigns: RayofSunshineGlass, PandoraStyleCharms, JinxiesBeads, TreasuredGems365, Jewelryliz
pillowsworld: LocalLivingSA, PandoraStyleCharms, JinxiesBeads, TreasuredGems365, JoDonJewelry
SweetLoveMansion: DespyVintage, AllthatJunk, Five3Three, PrimPrincess27, paperbagblues
LeChateauWoods: StillTreasured, Emotionless02, kidsvintage, SewSweetTots, jomannjewels
PiperDeveighDesigns: SewSweetTots, CammieCouture, kidsvintage, MrPaint, PandoraStyleCharms
PersonalGifts29045: GoodWood55, KustomIdeas, Ducky333, TiggyandMoggy, AtlantaCityBuilders
ButterflyBaskets: Jacksembroidery, TheLavenderFarmShop, PhotosbyMM, JoDonJewelry, PandoraStyleCharms
FrenchieNotIncluded: MrPaint, ThePaisleyPuppy, LittlePollyPockets, WeeWhimzyWardrobe, ThriftingNifties
LilLadyShop: MamaPileggi, MrPaint, OliviaClaireBows, kidsvintage, lacova
TheHauteHead: KellBellsCreations, OhlalaPretties, LovelyAdmirations, AlenaBlissYou, blgirard2451
JALDREHouseofCrochet: PandoraStyleCharms, JinxiesBeads, TreasuredGems365, JoDonJewelry, Jewelryliz
PcBBabies: darlintutus, bluemolasses, PrimPrincess27, DaintyDeerClothing, TiffaniCrafts
LittleWoollyWonders: lacova, FrediaCreations, OliviaClaireBows, CammieCouture, kidsvintage
REVEILLECOFFEEROAST: MrPaint, PandoraStyleCharms, JinxiesBeads, TreasuredGems365, Jewelryliz
girlpetadesigns: TiggyandMoggy, AtlantaCityBuilders, GoodWood55, Ducky333, ingrainedwoods2
GetKandied: 7on5, ChasingSif, ArtsyiPhoneCases, Chloescheerbows, JollyAccessories
ScrapbookingByKelly: MrPaint, MuggleMadeCreations, ClemsCards, JGHandcraftedCards, socraftyuk
KelmsCollectibles: CoinDelight, GlassCokeBottle, WellLovedTreasures, recyclemamaj, selectedcraft
BeachFrontBev: StephenWiseDesign, PaviaLee, HinesCustomDesigns, MrPaint, PandoraStyleCharms
NMSAntiques: TreasuredTinys, Ictalurus, MelindasVintage, Emotionless02, kidsvintage
ChesterInc: LoveChuckTaylors, bluemolasses, ChasingSif, ArtsyiPhoneCases, Chloescheerbows
Janabi: PandoraStyleCharms, kidsvintage, JinxiesBeads, TreasuredGems365, Jewelryliz
Bangarang85: JaneysThings, KeynoteCollectibles, beautynpizzazz, jesske000, Izzabellas
Tagom: RNWebStudio, ZakGarnerStudios, ZhannaArt, ShopEbbaLA, EvaSzorcFineArt
KirstykinsKreations: TissuesandTulipsTwo, MrPaint, MegFranBands, PandoraStyleCharms, JinxiesBeads
UnicornGlitterSoap: MrPaint, PandoraStyleCharms, JinxiesBeads, TreasuredGems365, JoDonJewelry
MEMsArtShop: PandoraStyleCharms, MelindasVintage, JinxiesBeads, TreasuredGems365, kidsvintage
StateofHappiness: allieandann, TristanTannerDesigns, SouthernBlessings002, pinkllamaprint, CHCVProductions
HomeDecorByAM: ifeelfelt, d3vka3la, littlewildlings, 11thDimensionDesigns, KittenSlacks
Sew4Generations: kidsvintage, PandoraStyleCharms, JinxiesBeads, TreasuredGems365, Jewelryliz
Ingridsorensenart: DMaxArt, kinkcircuit, ArtByAmaris, shivajiartstudios, AKBworkshop
lemonsandlimelight: MantisDesign, DoubleJRusticWorks, PigeonPoint, PCAShoponline, ThriftingNifties
CrochetEstates: KCsStudio44, MamaPileggi, FrediaCreations, CammieCouture, kidsvintage
carnivalcardcompany: ClemsCards, PandoraStyleCharms, JinxiesBeads, TreasuredGems365, Jewelryliz
ifeelfelt: 7on5, littlewildlings, GetKandied, SarahRobertsonShop, reckon69
shamana55: EllesHealing, Lovile, SoftsidedJewelry, Anitahafner, GlyAccessories
HonestCrafter: SuzysJewelryShop, OnTheBeSide, TinyTrack, HoopsPlus, SheebeezAccessories
GlitteryBugz: BrightFlowerHeadband, LanaArta, BlueRibbonBling, Chloescheerbows, ChasingSif
ErikasEtsyStore: AshNicoleCreations, FrediaCreations, AnnaKnittingShop, Inspiredbyababy, BeatriceBent
CrackedRabbits: LotusCards, EtherealPix, TheLadyAgnesShoppe, JamiesDoodles, PhotosbyMM
botaniclay: RingmasterPottery, JoDonJewelry, PandoraStyleCharms, JinxiesBeads, TreasuredGems365
OneMoreThriftStore: Emotionless02, kidsvintage, AllthatJunk, NULABA, MelindasVintage
IssleFashion: RebelRunnerz, UpcycleUrbanThrift, HindsightDenim, TreasuresfromtheBird, shortsbb
MastroroccoArt: ShoppingInParis, backintimeart, HelloClaireFashion, TwoGuysWed, RayofSunshineGlass
TheMcMatosCollection: Ictalurus, AnticqueShop, Izzabellas, ShopFrozenCharlotte, MelindasVintage
HabitCollections: MileHillAntiques, MakeThingsPretty, silvertime925, GreatValues, jomannjewels
Blondgirl39: UnderTheMysticTree, NovaSingularities, OHBracelets, HoopsPlus, FarahLarki
PeppisWorld: SmashedCopper, WearableSpoons, ParacordPatriot, CALIHustle, KajunsCrafts
AlainChayerArt: Lifeinwatercolor4u, FranchaCavitt, GabesSprayPaintArt, MrPaint, backintimeart
GrandmasLegacies: NotGREY, LocalLivingSA, OllieandMrBear, serendipitypillows, VarmCountry
PursesbyKelsey: inmyattictoyours, SheekBurlapDesigns, LeChateauWoods, GudrunStitches, CitySeamsHandbags
luvinlaundry: GreatGiftsToGo, OliviasLoops, PureLoveCrosses, ProverbMagnets, LavantaCoffee
bestinsteam: MrPaint, PandoraStyleCharms, JinxiesBeads, TreasuredGems365, JoDonJewelry
EverthingNice: AshNicoleCreations, RosaBlancaBaby, FrediaCreations, CammieCouture, Inspiredbyababy
EreWhile: kidsvintage, PandoraStyleCharms, MelindasVintage, JinxiesBeads, TreasuredGems365
Waggonerra1: Acmeproducts, ParacordPatriot, CALIHustle, KajunsCrafts, jomannjewels
CaptainHannaArt: Machlev, ChristopherOakden, billjamespainting, FedwellFarm, ArtByMuns
SweetDecorUK: PandoraStyleCharms, JinxiesBeads, TreasuredGems365, Jewelryliz, JoDonJewelry
JeanneBeanCreations: 11thDimensionDesigns, Malamutemax, GreatGiftsToGo, PureLoveCrosses, HandmadebyPurplePopp
PursuingVintage1: LottiesVintageAttic, ThriftingNifties, AuntieNeeNee, JEMImages, NataliesFabArt
nicebabycrochet: SweetTeaNme, BeatriceBent, Inspiredbyababy, LeChapelle, KCsStudio44
WinfordWorks: WallaceForge, RusticRevelations, TiggyandMoggy, AtlantaCityBuilders, Back40SignzTexas
Roostic: AmericanLandWP, StickKettleOn, WineDine, ArtisanSlate, JuteByVictoria
Karaswreaths: MyDoorToYourDoor, SheekBurlapDesigns, OllieandMrBear, TissuesandTulipsTwo, VarmCountry
MustangRescue: SarahRobertsonShop, MrPaint, MelindasVintage, PandoraStyleCharms, kidsvintage
PrettyPleasePartyBou: AlwaysRoomforJello, BeatriceBent, LeChapelle, OliviaClaireBows, lacova
TheSnarkade: PandoraStyleCharms, JinxiesBeads, TreasuredGems365, Jewelryliz, JoDonJewelry
SparkleBeautyProduct: TribalTees, Frederike11, Ecohippychic, dummymummyuk, ribbonextravaganza
PAPIERWERKEN: RayofSunshineGlass, hereonart, SweetSugarPixels, creabonbon, PandoraStyleCharms
BlingChicken: Reenesplace, aplauso, MrPaint, CitySeamsHandbags, LeChateauWoods
TickleTs: EllePrelleDesigns, MeanKids, Overthemoonbcn, DeadbeatCustoms, MamaPileggi
MemoryJars: SuzzieBee, DomesticMcgyver, AFirstEdition, faboandme, TheresaNPieces
ArtPendant: JinxiesBeads, TreasuredGems365, PandoraStyleCharms, JoDonJewelry, Jewelryliz
AliyanasBowtique: JubileesJoy, KellBellsCreations, OhlalaPretties, LovelyAdmirations, TimothyLandes
StuffandStuffies: PandoraStyleCharms, JinxiesBeads, TreasuredGems365, JoDonJewelry, Jewelryliz
LuLunaCollectables: WoodturningRoss, ThriftingNifties, jomannjewels, Emotionless02, MrPaint
TinyTrack: reckon69, PandoraStyleCharms, JinxiesBeads, TreasuredGems365, Jewelryliz
bibaworks: JUMBOkitten, ChesterInc, bluemolasses, SparkleAndCharming, FedwellFarm
PauzaDamascusArt: SteveSimpsonShop, LolaMontejo, RingsmuthWelding, FeyMosacis, DemoRSShop
SmArtWrApparel: HelloClaireFashion, TheLadyAgnesShoppe, PandoraStyleCharms, JinxiesBeads, TreasuredGems365
RorreyYatesDesigns: JoTunmer, Freedom1001, Flintsworld, SweetPeaBoogie, ZYOENTERTAINMENT
AHintonDesigns: RosaBlancaBaby, AshNicoleCreations, OverTheTopDaiperCake, MrPaint, FrediaCreations
MantisDesign: PigeonPoint, ThriftingNifties, PCAShoponline, LocalLivingSA, Izzabellas
LoveDNA: PureLoveCrosses, MrPaint, PandoraStyleCharms, JinxiesBeads, TreasuredGems365
lacova: OliviaClaireBows, ArtsyiPhoneCases, CammieCouture, kidsvintage, JollyAccessories
SouthPawDesignsART: TwoGuysWed, ClemsCards, JGHandcraftedCards, MrPaint, PandoraStyleCharms
CreationsMade4You: YazzyandMeCreations, KellBellsCreations, RagBabyDesigns13, JollyAccessories, ChasingSif
OMGLocketsandcharms: RoxfordOriginals, SheebeezAccessories, Tinasuniquedesigns, Lovile, Trailblazer28
KellyMaddock: PandoraStyleCharms, JinxiesBeads, TreasuredGems365, TJMJewelry, FarahLarki
KG204shop: faboandme, bluemolasses, TinkieTies, StylePowerShop, DeadbeatCustoms
CampusBakes: TasteWales, MuseDeFrance, SweetBitesRichmond, BELLSBARKERY, PandoraStyleCharms
JGDesignerCrafts: SewLovinIt1, LavantaCoffee, CraftsByDre, GreatGiftsToGo, PureLoveCrosses
TimeYieldsTreasure: PaisleyParkVintage, MelindasVintage, SoftsidedJewelry, Emotionless02, JoDonJewelry
RETROPRIDE: Emotionless02, kidsvintage, MelindasVintage, PandoraStyleCharms, MrPaint
KitchenKovers: lacova, OliviaClaireBows, CammieCouture, ArtsyiPhoneCases, kidsvintage
ZoeVictoriaAccessory: MountainRagz, BekkaBeek, MrPaint, inmyattictoyours, LeChateauWoods
TasteWales: MuseDeFrance, SweetBitesRichmond, PandoraStyleCharms, JinxiesBeads, TreasuredGems365
JenandJamie13: PrimPrincess27, MrPaint, lacova, OliviaClaireBows, FrediaCreations
TheoryOneClothing: DMMonogramming, TeaseCouture, faboandme, StylePowerShop, DeadbeatCustoms
BabyBegoniaProps: KellBellsCreations, OhlalaPretties, JollyAccessories, RagBabyDesigns13, blgirard2451
Catspergers: FuwafuwaKuma, MeganAngelDesign, TristanTannerDesigns, laurenmtrump, JUMBOkitten
LottiesVintageAttic: ThriftingNifties, jomannjewels, Emotionless02, LeChateauWoods, Izzabellas
SophiasaShop: MamaRavens, TheAcornFairy, WonderWomanz, PamiesPatterns, ParacordPatriot
ManaCase: JokoCase, EfenCase, SenoCase, CandraCase, JarwoCase
IridescentPhotos: PhotosbyMM, PandoraStyleCharms, JinxiesBeads, TreasuredGems365, RayofSunshineGlass
DigitalNewYork: WalkinsWelcome, LotusCards, GabesSprayPaintArt, DeSooza, PhotosbyMM
TheAcornFairy: MamaRavens, WonderWomanz, PamiesPatterns, ParacordPatriot, funjewls4u
AksesuhrizHOME: JenGrace57, SIXTWENTYTWOEIGHTY, ArtbyElizabethK, ArtByAmaris, TheCanvasCorner
SewBette: AllThatGlittersHC, PigeonPoint, ModernCntry, JoDonJewelry, Alaskanpolarhugs
PictureYourSeat: LeChapelle, PandoraStyleCharms, JinxiesBeads, TreasuredGems365, JoDonJewelry
UncannyStyling345: MrPaint, LotusCards, RayofSunshineGlass, PandoraStyleCharms, JinxiesBeads
LotsofParty: ONLY1NICOLE, StillTreasured, misterlisters, SewSweetTots, ElizaDaysVintage
LocalLivingSA: PandoraStyleCharms, JinxiesBeads, TreasuredGems365, Jewelryliz, JoDonJewelry
NeronaStreet: Jewelryliz, JinxiesBeads, TreasuredGems365, JoDonJewelry, MeltingWithLight
Codyscustomcreations: DomesticMcgyver, AFirstEdition, MantisDesign, faboandme, MakeThingsPretty
FrantasticCards: Angelislandvinyl, AliceInGraphicLand, SouthPawDesignsART, EllisRJones, TwoGuysWed
NaturesHardwear: BeatriceBent, PandoraStyleCharms, JinxiesBeads, TreasuredGems365, kidsvintage
SpecialtyTowels: Kattugle, WarmFeelings, HandmadebyPurplePopp, ChasingSif, ArtsyiPhoneCases
AuntBeasBlingToo: TreasuredGems365, JinxiesBeads, JoDonJewelry, Jewelryliz, PandoraStyleCharms
LeatherChipsChains: PandoraStyleCharms, LoveBraceletsByAna, TreasuredGems365, JinxiesBeads, Jewelryliz
Stepharella: GreatValues, NotGREY, PhotosbyMM, LocalLivingSA, JoDonJewelry
EzzzyQuilting: JoDonJewelry, PandoraStyleCharms, JinxiesBeads, TreasuredGems365, Jewelryliz
TheRenegadeVintage: LovelyClassyFinds, B16Design, Emotionless02, kidsvintage, MelindasVintage
BabySweetHart: EllieAtMaluno, DuckDuckDragon, RoyalTendency, AllAboutRags, CakedayAU
Igulim: lakeandtower, PurpleDotty, nicebabycrochet, KCsStudio44, MrPaint
lookatmedollclothes: WeeWhimzyWardrobe, JoDonJewelry, PandoraStyleCharms, JinxiesBeads, TreasuredGems365
JubileesJoy: JollyAccessories, MegFranBands, PandoraStyleCharms, JinxiesBeads, TreasuredGems365
Mullicamomsoycandles: PandoraStyleCharms, JinxiesBeads, TreasuredGems365, Jewelryliz, JoDonJewelry
Origaminni: PAPIERWERKEN, MMsJewelry, FarahLarki, PaisleyParkVintage, LetsTalkTagua
GoodeCatchDesign: PandoraStyleCharms, TreasuredGems365, JinxiesBeads, JoDonJewelry, Jewelryliz
TheCustomerFirst: GaSouthernLights, CollsCoveredBoxes, OliviasLoops, JaimeKupfner, petalsbymelissa
AllanSchuler: MrPaint, MikeHaroArt, GabesSprayPaintArt, kinkcircuit, StudioKQL
Lemonadedaily: MamaPileggi, kidsvintage, CammieCouture, SewSweetTots, OliviaClaireBows
SpentRounds: Hytek3D, MadeByTheRedHead, PillowGroomers, petalsbymelissa, OliviasLoops
BitterCreak: WasteYrPrints, TheLadyAgnesShoppe, Lithographia, RachiPrints, JamiesDoodles
TheFunkyOwlJewelry: JinxiesBeads, TreasuredGems365, Jewelryliz, NeronaStreet, JoDonJewelry
KidLog: PandoraStyleCharms, JinxiesBeads, TreasuredGems365, kidsvintage, Jewelryliz
CatchUOnTheFlipSide: PCAShoponline, PeculiarPens, PandoraStyleCharms, JinxiesBeads, TreasuredGems365
annidomino: ErikasEtsyStore, Wightstitches, DerStickbaer, DIYbyEricaB, AnnaKnittingShop
ThePatchworkGoat: FrediaCreations, Inspiredbyababy, lacova, Jacksembroidery, OliviaClaireBows
Maylandia: JenGrace57, SIXTWENTYTWOEIGHTY, AksesuhrizHOME, ArtbyElizabethK, ArtByAmaris
SheIsSewVegan: PandoraStyleCharms, JinxiesBeads, TreasuredGems365, Jewelryliz, JoDonJewelry
FeltBabyDesign: OliviaClaireBows, kidsvintage, PandoraStyleCharms, JinxiesBeads, TreasuredGems365
DriftwoodCrazy: MrPaint, hereonart, CammieCouture, RayofSunshineGlass, LocalLivingSA
SouthernCakeToppers: PandoraStyleCharms, JinxiesBeads, TreasuredGems365, Jewelryliz, SweetBitesRichmond
LightBlooms: Hoctavius, WarriorPrincessGems, ManchesterDoula, GoodeCatchDesign, Lovile
FurryGraphicDesign: CraftingEssentials, PandoraStyleCharms, JinxiesBeads, TreasuredGems365, JoDonJewelry
KoalaScrawwls: WasteYrPrints, TheLadyAgnesShoppe, JamiesDoodles, RayofSunshineGlass, PandoraStyleCharms
AirWingGraphics: IPcase, PandoraStyleCharms, JinxiesBeads, TreasuredGems365, MrPaint
PurpleDotty: PandoraStyleCharms, JinxiesBeads, TreasuredGems365, Jewelryliz, JoDonJewelry
FunAndFreshJewels: Trailblazer28, funjewls4u, Tinasuniquedesigns, MrPaint, Insomny
BettyFinds: copperscrafts, JillsMakings, TissuesandTulipsTwo, CraftsbyAJ, MelindasVintage
bluemolasses: PrimPrincess27, DeadbeatCustoms, HandPaintedTees, MamaPileggi, DIGDIN6
MENTOSDRIVE: SANTAFELEATHER, ArtsyiPhoneCases, JollyAccessories, PandoraStyleCharms, JinxiesBeads
serendipitypillows: BellatiqueFabrics, LocalLivingSA, PandoraStyleCharms, JinxiesBeads, TreasuredGems365
ShellyByTheBay: Trailblazer28, funjewls4u, SoftsidedJewelry, JoDonJewelry, Lovile
SweetAndLocks: MrPaint, SweetBitesRichmond, JoDonJewelry, PandoraStyleCharms, JinxiesBeads
hereonart: RayofSunshineGlass, PandoraStyleCharms, JinxiesBeads, TreasuredGems365, Jewelryliz
CountryBlings: JinxiesBeads, TreasuredGems365, Jewelryliz, NeronaStreet, JoDonJewelry
WMEmbroidery: DonnaMaggioDesigns, ZumbaFashions, TeaseCouture, DMMonogramming, DIGDIN6
DrikaBijoux: NeronaStreet, Jewelryliz, FarahLarki, JoDonJewelry, TreasuredGems365
BrushJunkie: UnderTheMysticTree, NovaSingularities, SoftsidedJewelry, JoDonJewelry, OHBracelets
MikeFeehan: ErinPhippsDesigns, TheLadyAgnesShoppe, OhSoPrintableDesigns, WasteYrPrints, OfficialWondercraft
MonochromaticDesigns: WeCanDraw, Courtelisedesigns, backintimeart, MrPaint, hereonart
AvaBelleBoutique: kidsvintage, PandoraStyleCharms, JinxiesBeads, TreasuredGems365, Jewelryliz
FingerLightningPress: LittleAlmondsShop, DiamondClarity, JonWoodhamsPhotos, KnotThatNautical, Malamutemax
KenziesTreasureChest: KellBellsCreations, RagBabyDesigns13, JollyAccessories, LavantaCoffee, OliviaClaireBows
AeYoungJewelry: UnderTheMysticTree, bylaurab, OHBracelets, PamiesPatterns, SheebeezAccessories
AAA1furniture: LottiesVintageAttic, ThriftingNifties, JoDonJewelry, ViviansCrown, PandoraStyleCharms
NotGREY: PandoraStyleCharms, JinxiesBeads, TreasuredGems365, Jewelryliz, JoDonJewelry
BigRedArts: WordPouch, laurenmtrump, LivingSpiritDesign, MeganAngelDesign, FuwafuwaKuma
Paracord639: Shavingwood, meryprovi, IndyParacord, SparklingDezign, BlazinBeader
KayJaceCreations: CammieCouture, OliviaClaireBows, kidsvintage, FeltBabyDesign, lacova
bowsbeforebrosxo: RagBabyDesigns13, KellBellsCreations, JollyAccessories, OliviaClaireBows, ArtsyiPhoneCases
Bowtique27: RagBabyDesigns13, bowsbeforebrosxo, JollyAccessories, MegFranBands, OliviaClaireBows
GLAMSANITY: MakeThingsPretty, LittlePollyPockets, MileHillAntiques, jomannjewels, GreatValues
DesignedbyJB: nitrogeek2012, LottiesVintageAttic, ThriftingNifties, PhotosbyMM, JoDonJewelry
RandomGiftShop: 2manos, CarolinasLittleShop, Alyxsthriftyboutique, MantisDesign, HoughtonsHouses
jomannjewels: Emotionless02, PaisleyParkVintage, MelindasVintage, kidsvintage, LovelyClassyFinds
KnotThatNautical: JGHandcraftedCards, ClemsCards, JinxiesBeads, TreasuredGems365, Jewelryliz
StinkyStickers: MantisDesign, PigeonPoint, PCAShoponline, ThriftingNifties, LocalLivingSA
OurCraftBazaar: HaileyPoo, SweetTeaNme, nicebabycrochet, KCsStudio44, JoDonJewelry
SecondChanceAttic: PigeonPoint, MantisDesign, ThriftingNifties, jesske000, MrPaint
TriciasBabyQuilts: barndoorantiques, SarahRobertsonShop, AshNicoleCreations, HandmadebyPurplePopp, FrediaCreations
ARTBYWYNN: MilaAbstract, GabesSprayPaintArt, StudioKQL, hereonart, RayofSunshineGlass
DesignsBySondra: AcornParty, CharmedLifeBoutique1, GoodeCatchDesign, SheebeezAccessories, Lovile
KidsznBabiesNThings: ThePaisleyPuppy, RosaBlancaBaby, AshNicoleCreations, OverTheTopDaiperCake, barndoorantiques
Fancylovejewels: BelleAnnDesigns, Firstlightmineral, ArtsyiPhoneCases, MamaPileggi, Overthemoonbcn
AdorablyAdornedHolly: MaddThreads, CammieCouture, FrediaCreations, TwinsiesTotShop, TushieTreats
Braxious: MamaPileggi, AllthatJunk, NULABA, kidsvintage, PandoraStyleCharms
ShizzlerMtG: StinkyStickers, PandoraStyleCharms, JinxiesBeads, TreasuredGems365, JoDonJewelry
ByAlegria: TwoGuysWed, ShoppingInParis, TutusKorner, GothamPatterns, progressiveprint
GlyAccessories: JoDonJewelry, PrincessJewelsByCaly, SoftsidedJewelry, Jewelryliz, MelindasVintage
SusiesDLites: MagicalCase, CraftingEssentials, PandoraStyleCharms, JinxiesBeads, TreasuredGems365
ThirdRoomDesigns: JoDonJewelry, NovaSingularities, TreasuredGems365, JinxiesBeads, PandoraStyleCharms
socraftyuk: ClemsCards, PandoraStyleCharms, TreasuredGems365, JinxiesBeads, Jewelryliz
annimaarit: DavidBoydJrFineArt, PhotosbyMM, WalkinsWelcome, LotusCards, RayofSunshineGlass
TheCritterArtist: FranchaCavitt, RayofSunshineGlass, hereonart, GabesSprayPaintArt, PandoraStyleCharms
ChapeauHatBettyL: BeatriceBent, AlwaysRoomforJello, LeChapelle, NaturesHardwear, KARYMUSA
darebefun: Debee333, HappyHippyCrafts, MamaRavens, TheAcornFairy, WonderWomanz
BellatiqueFabrics: PandoraStyleCharms, JinxiesBeads, TreasuredGems365, Jewelryliz, MelindasVintage
BekkaBeek: MMsJewelry, ArtPendant, PaisleyParkVintage, JinxiesBeads, ViviansCrown
MoonsieCreations: OHBracelets, NovaSingularities, PandoraStyleCharms, JoDonJewelry, TreasuredGems365
FancyWoods: MAJOECREATIONS, ribbonextravaganza, coralnbeads, Frederike11, dummymummyuk
DMMonogramming: TeaseCouture, HandPaintedTees, MamaPileggi, DeadbeatCustoms, EllePrelleDesigns
HouksWoodworks: Back40SignzTexas, ingrainedwoods2, Ducky333, PeculiarPens, PCAShoponline
designsbyashliet: LeChapelle, PandoraStyleCharms, JinxiesBeads, TreasuredGems365, Jewelryliz
UtsukushiiSekai: MiSophie, Creativebags28, Tekmates, AlenaBlissYou, BCStudioDesigns
CakedayAU: KitchenKovers, serendipitypillows, BellatiqueFabrics, OliviaClaireBows, lacova
copperscrafts: SweetTeaNme, nicebabycrochet, ChansCrochetCreation, BettyFinds, HaileyPoo
ShinShinPrincess: lookatmedollclothes, JJCrystalinewings, WeeWhimzyWardrobe, ElenaBelova, BlackbirdSecrets
RogerMartinezArt: CreativeArtByJMintze, StudioKQL, PhotosbyMM, JLImagery, PandoraStyleCharms
RocksofNature: Trailblazer28, funjewls4u, Tinasuniquedesigns, Insomny, ViviansCrown
NZLandscapes: WalkinsWelcome, GabesSprayPaintArt, DeSooza, LotusCards, StudioKQL
LadiesHutchinson: PandoraStyleCharms, TreasuredGems365, JinxiesBeads, MelindasVintage, CountryBlings
Flatback: OliviasLoops, petalsbymelissa, MadeByTheRedHead, PillowGroomers, GaSouthernLights
MessieNessie13: Malamutemax, TheBookCellarmt, jomannjewels, Emotionless02, ThriftingNifties
Trailblazer28: SoftsidedJewelry, funjewls4u, Lovile, MeltingWithLight, moonspecies
MatiSofi: VintageAlene, JamaicaSandalCo, inmyattictoyours, GudrunStitches, LeChateauWoods
AuburnEmporium: PandoraStyleCharms, TreasuredGems365, JinxiesBeads, Jewelryliz, MelindasVintage
COLOURLENSES: ThreadbareLab, WyldeBrambleEmporium, YorktownCrafts, BellaVitaDesignsYona, TeaseCouture
CrochetSundries: MrPaint, SewSweetTots, misterlisters, MamaPileggi, kidsvintage
CharmedLifeBoutique1: SheebeezAccessories, Lovile, SoftsidedJewelry, JoDonJewelry, NovaSingularities
ComputerPictures: maryannevansart, pinkllamaprint, WasteYrPrints, TristanTannerDesigns, KvoFolkArt
MzCheyZDesigns: NotGREY, CraftyLeaves, PaintingsforPJ, depressivepaintings, BCStudioDesigns
UfairaCraft: CrossRoman, KasiaWorks, finitestitches, Kattugle, SpecialtyTowels
BellyDanceBlingShop: JoDonJewelry, ViviansCrown, Jewelryliz, NeronaStreet, TreasuredGems365
BitsyBitsyBows: littleBOWSdelivery, SheIsSewVegan, SugarDame, AuntMolliesHairBows, MegFranBands
kmfletcherphoto: WalkinsWelcome, LotusCards, EtherealPix, PhotosbyMM, LauraInkPhotography
447Woodworks: MrPaint, JoDonJewelry, MeltingWithLight, NeronaStreet, Jewelryliz
StagMeadowBathCo: kaeleyjanephoto, LotusCards, WalkinsWelcome, GabesSprayPaintArt, DeSooza
SenoCase: JokoCase, EfenCase, ManaCase, CandraCase, JarwoCase
PrimPrincess27: OliviaClaireBows, kidsvintage, MamaPileggi, CammieCouture, SewSweetTots
maryannevansart: GabesSprayPaintArt, TheLadyAgnesShoppe, RayofSunshineGlass, WasteYrPrints, hereonart
MYLITTLEWITCHSTORE: KattySwan, MrPaint, GreatGiftsToGo, PureLoveCrosses, JoDonJewelry
SugarcoatedSisters: OHBracelets, UnderTheMysticTree, NovaSingularities, ViviansCrown, SheebeezAccessories
ChicanoSoulPhotos: PhotosbyMM, PandoraStyleCharms, JamiesDoodles, JinxiesBeads, TreasuredGems365
LucysBitsandBobs: CoinDelight, GlassCokeBottle, WellLovedTreasures, recyclemamaj, selectedcraft
ThePixelPlaza: NinjaShayRenee, StinkyStickers, ShizzlerMtG, RobynsJewellery, MrPaint
handpickedhomemade: PaviaLee, CGDbyMeryl, TimothyLandes, PartyFlask, MrPaint
blankettheworld: TheBeautifulLife5, JALDREHouseofCrochet, SweetTeaNme, HaileyPoo, nicebabycrochet
lakeandtower: PandoraStyleCharms, JinxiesBeads, TreasuredGems365, Jewelryliz, JoDonJewelry
RachelMsQuilts: Pappiyon, Indianparadise, MrPaint, NaturesHardwear, NULABA
BlindInspiration: DimensionZero, pinkllamaprint, WasteYrPrints, TopTopps, KvoFolkArt
kaeleyjanephoto: LotusCards, WalkinsWelcome, EtherealPix, PhotosbyMM, hereonart
MallolDesign: SteveSimpsonShop, LolaMontejo, RingsmuthWelding, FeyMosacis, PauzaDamascusArt
LWurtenbergStudio: TristanTannerDesigns, CzaraArt, SouthernBlessings002, kimbrenasdesigns, pinkllamaprint
IrvinBombArt: RNWebStudio, TheCritterArtist, ZhannaArt, TeamCuenod, EvaSzorcFineArt
TreasuresfromtheBird: AlwaysRoomforJello, NaturesHardwear, BeatriceBent, MrPaint, LeChapelle
HelloClaireFashion: TheLadyAgnesShoppe, PandoraStyleCharms, JinxiesBeads, TreasuredGems365, LivingSpiritDesign
CraftyTreasuresbyEmi: JJHut, JoDonJewelry, NovaSingularities, TreasuredGems365, PandoraStyleCharms
SunshinyDaysBoutique: AuntMolliesHairBows, SuperCuteClippies, kidsvintage, CammieCouture, PandoraStyleCharms
Tesher: HandmadeChandeliers, LottiesVintageAttic, ThriftingNifties, JoDonJewelry, PandoraStyleCharms
BagsbySwampee: SandraStitched, CitySeamsHandbags, LilBlueBirdy, B16Design, MrPaint
SweetPsGifts: NotGREY, serendipitypillows, LocalLivingSA, BellatiqueFabrics, SandraStitched
RainyDaysandSunshine: PandoraStyleCharms, JinxiesBeads, TreasuredGems365, Jewelryliz, JoDonJewelry
Netphoto: CHCVProductions, WalkinsWelcome, TheThingsTheyCarried, DavidBoydJrFineArt, LauraInkPhotography
MysticResonance: SheebeezAccessories, UnderTheMysticTree, OHBracelets, NovaSingularities, ViviansCrown
OverTheTopDaiperCake: RosaBlancaBaby, AshNicoleCreations, FrediaCreations, Inspiredbyababy, Jacksembroidery
VarmCountry: JinxiesBeads, TreasuredGems365, PandoraStyleCharms, Jewelryliz, NeronaStreet
AKBworkshop: shivajiartstudios, kinkcircuit, StudioKQL, RayofSunshineGlass, PandoraStyleCharms
DzCreationz: PandoraStyleCharms, JinxiesBeads, TreasuredGems365, Jewelryliz, kidsvintage
ChasingThere: PinOnArt, AllieAnnsAttic, HighCottonSouthernCo, SerenitysWay, alittlehopedesigns
StormyTreeCrafts: BigRedArts, MastroroccoArt, littlewildlings, SouthernBlessings002, progressiveprint
metriczinc: JoDonJewelry, TreasuredGems365, JinxiesBeads, Jewelryliz, MelindasVintage
TopTopps: PandoraStyleCharms, JinxiesBeads, TreasuredGems365, Jewelryliz, JoDonJewelry
JSEDesigns: MuggleMadeCreations, SharonGreetingCards, MrPaint, ClemsCards, JGHandcraftedCards
Emilyscaketoppes: GreatGiftsToGo, PureLoveCrosses, socraftyuk, MrPaint, LavantaCoffee
GrandmasAttic2013: SweetTeaNme, PetsLoveBlingToo, nicebabycrochet, LittlePollyPockets, KCsStudio44
MattMonSac: PandoraStyleCharms, JinxiesBeads, TreasuredGems365, MrPaint, Jewelryliz
Mapology: PandoraStyleCharms, JinxiesBeads, TreasuredGems365, RayofSunshineGlass, JoDonJewelry
ChicandCouture: ArtsyiPhoneCases, KathyLizBoutique, JollyAccessories, KARYMUSA, ChasingSif
7on5: GetKandied, ArtsyiPhoneCases, JollyAccessories, OliviaClaireBows, ChasingSif
luadds: JoDonJewelry, NovaSingularities, TreasuredGems365, JinxiesBeads, PandoraStyleCharms
BlackbirdSecrets: PandoraStyleCharms, JinxiesBeads, TreasuredGems365, Jewelryliz, JoDonJewelry
CaptainsLoot: JaimeBouteilles, SweetCupCrafts, RingmasterPottery, CourageousCats, FieldsofFandom
MichellesNYC: MikaylasBooks, LovinHateStreet, FayesFabFinds, TRINKETSandTREASURE1, ThriftingNifties
AngelWingsCandles: Mullicamomsoycandles, TheLavenderFarmShop, PhotosbyMM, OhSoPrintableDesigns, JoDonJewelry
NinjaShayRenee: StinkyStickers, MrPaint, SnicketsSnippets, LadyBirdesign, reckon69
JoyfulYarnsCrochet: nicebabycrochet, MrPaint, AKECreations, NaturesHardwear, BeatriceBent
HOT8BitPix: TheThingsTheyCarried, pinkllamaprint, FunFunkyU, BluePeriodArt, hereonart
StudioJFashionDesign: UnderTheMysticTree, NovaSingularities, SoftsidedJewelry, SheebeezAccessories, JoDonJewelry
GeminisCreations: MagicalCase, SarahRobertsonShop, RyanTokoku, casesinstyle, reckon69
RilyThomas: GuineveresGames, MrPaint, SatinSouthernFlare, lacova, OliviaClaireBows
FantastikKreations: ArtShoppeCrafts, FlowerStudio13, PictureYourSeat, LabiosDeMel, VintageWinery
CMPBeadJeweled: aDORYble, adayatthebeach2, BsEce, TheresaNPieces, Lovile
MoradoBags: PandoraStyleCharms, SANTAFELEATHER, JinxiesBeads, TreasuredGems365, Jewelryliz
TeriHillDesign: WarmFeelings, WithloveKaty, LocalLivingSA, CraftsbyAJ, MrPaint
HinesCustomDesigns: PandoraStyleCharms, JinxiesBeads, TreasuredGems365, Jewelryliz, MelindasVintage
MelnErikasBirdhouses: soniahalejak, MrPaint, TheresaNPieces, DomesticMcgyver, Ringo2011
Pictureperfectplaque: Hytek3D, MadeByTheRedHead, PillowGroomers, petalsbymelissa, OliviasLoops
FloridaWeddingStuff: ArtShoppeCrafts, FlowerStudio13, KellBellsCreations, RagBabyDesigns13, MedfordandBrooke
Beesafe: lacova, FrediaCreations, OliviaClaireBows, AshNicoleCreations, FishGirlFashions
littlewildlings: JollyAccessories, OliviaClaireBows, kidsvintage, PandoraStyleCharms, JinxiesBeads
christiantcantiello: DimensionZero, SouthernBlessings002, pinkllamaprint, WasteYrPrints, TopTopps
MariaLourdesShop: SewSweetTots, StillTreasured, kidsvintage, DiversityByCookie, SewSolutions
LittleCiciShop: PandoraStyleCharms, JinxiesBeads, TreasuredGems365, Jewelryliz, JoDonJewelry
SmallStonez: backintimeart, RayofSunshineGlass, hereonart, StudioKQL, PandoraStyleCharms
FestinaOriginalLente: hereonart, FunFunkyU, RayofSunshineGlass, creabonbon, colourpad
WendyBKnits: DIGDIN6, AzMtnBlue, CrystalCoutureDesign, MamaPileggi, HandPaintedTees
TANERITAKI: Lovile, SoftsidedJewelry, JoDonJewelry, junjieshop, ArtPendant
WallaceForge: MrPaint, Back40SignzTexas, ThriftingNifties, PandoraStyleCharms, JinxiesBeads
newyorkarchive: Emotionless02, MelindasVintage, kidsvintage, PandoraStyleCharms, JinxiesBeads
judygdesigns: SparklingDezign, BlazinBeader, MeltingWithLight, moonspecies, EllesHealing
CosiDolce: misterlisters, LeChateauWoods, DragonflyTease, MamaPileggi, Emotionless02
POESSI: BeastetteWristWraps, JollyAccessories, SANTAFELEATHER, MegFranBands, SatinSouthernFlare
JoePgraffiti: FuwafuwaKuma, MeganAngelDesign, RogerMartinezArt, laurenmtrump, JUMBOkitten
TheShabbyCraftShack: MatMantra, creationsbyrobyn1, GaSouthernLights, CollsCoveredBoxes, petalsbymelissa
DharmaShine: BsEce, MrPaint, CraftingEssentials, JinxiesBeads, TreasuredGems365
BillDavisPotteryShop: PandoraStyleCharms, JinxiesBeads, TreasuredGems365, JoDonJewelry, Jewelryliz
Lightsupmylife: bottleddesign, DomesticMcgyver, AFirstEdition, faboandme, MrPaint
BisuteriaYasmin: byClementine, BekkaBeek, SparklingDezign, LamimSterling, BlazinBeader
AsYouFancy: ElBabyBoutique, NachoMamasQuilt, canvasanni, CitySeamsHandbags, MrPaint
StayRuthless: TheThingsTheyCarried, pinkllamaprint, FunFunkyU, hereonart, RayofSunshineGlass
ChrismanCreations: SweetBitesRichmond, JollyAccessories, RagBabyDesigns13, TissuesandTulipsTwo, JoDonJewelry
MetalMadeArt: SuelyneeHo, RayofSunshineGlass, hereonart, DeadbeatCustoms, kidsvintage
VelvetMush: EtchGear, TopTopps, MrPaint, MamaPileggi, MeanKids
FromTheHeartByTam: HoopsPlus, MeltingWithLight, moonspecies, SoftsidedJewelry, ViviansCrown
CrownLinen: Kattugle, SpecialtyTowels, WarmFeelings, DerStickbaer, WithloveKaty
CosasAndThings: PaisleyParkVintage, PrincessJewelsByCaly, MMsJewelry, MrPaint, ViviansCrown
silvertime925: MileHillAntiques, MakeThingsPretty, GreatValues, MissionHouse, KeynoteCollectibles
ALaModePhotographic: ZYOENTERTAINMENT, RufioPortraits, JohannaFalzone, FedwellFarm, JUMBOkitten
bebehoney: TasteWales, MuseDeFrance, SweetBitesRichmond, PhotosbyMM, JoDonJewelry
PoppyAndThistle: LovelyClassyFinds, StillTreasured, jomannjewels, Emotionless02, PaisleyParkVintage
BexJewellery: PamiesPatterns, UnderTheMysticTree, SheebeezAccessories, bylaurab, BrushJunkie
randomcraftery: SteveSimpsonShop, LolaMontejo, RingsmuthWelding, FeyMosacis, PauzaDamascusArt
JoTunmer: Freedom1001, Flintsworld, SweetPeaBoogie, ZYOENTERTAINMENT, StudioKQL
ParacordByBrylie: ChasingSif, ArtsyiPhoneCases, Chloescheerbows, JollyAccessories, OliviaClaireBows
VanebulaPins: PandoraStyleCharms, JinxiesBeads, TreasuredGems365, Jewelryliz, JoDonJewelry
darlintutus: bluemolasses, PrimPrincess27, FishGirlFashions, HandPaintedTees, DIGDIN6
AshsPracticalMagic: UnderTheMysticTree, NovaSingularities, SheebeezAccessories, SoftsidedJewelry, MrPaint
MagieNoireRo: PandoraStyleCharms, JinxiesBeads, TreasuredGems365, SewSweetTots, Jewelryliz
MAWTH: JenGrace57, SIXTWENTYTWOEIGHTY, AksesuhrizHOME, ArtbyElizabethK, ArtByAmaris
CammieCouture: kidsvintage, PandoraStyleCharms, JinxiesBeads, TreasuredGems365, Jewelryliz
ChimericalDesigns: serendipitypillows, BellatiqueFabrics, NotGREY, LocalLivingSA, SandraStitched
SugarDame: PandoraStyleCharms, JinxiesBeads, TreasuredGems365, Jewelryliz, MelindasVintage
SwimmingInThoughts: DomesticMcgyver, AFirstEdition, TheShapeOfMySpace, StringBeanBoutique17, faboandme
LeatherGemsJewelry: EllesHealing, Anitahafner, TheresaNPieces, Izzabellas, OrgonizeYourLife
ChristopherOakden: Machlev, billjamespainting, FedwellFarm, BellaVitaDesignsYona, GabesSprayPaintArt
CuteAsaButtonCompany: FarahLarki, JinxiesBeads, TreasuredGems365, Jewelryliz, NeronaStreet
QueensDomain: DragonflyTease, DMMonogramming, GeekJock, DIGDIN6, AzMtnBlue
HMCvintage: EllesHealing, Anitahafner, PaisleyParkVintage, MelindasVintage, Lovile
followthefeathers: Izzabellas, jomannjewels, PaisleyParkVintage, jolantakrajewska, Emotionless02
SketchersAnonymous: SteveSimpsonShop, LolaMontejo, RingsmuthWelding, FeyMosacis, PauzaDamascusArt
DesertHoneysuckle: JollyAccessories, MegFranBands, RagBabyDesigns13, LotusCards, SatinSouthernFlare
KnitALush: madewithlovebyjennie, WarmedbytheHearth, RosaBlancaBaby, OverTheTopDaiperCake, AshNicoleCreations
BrasiliaBeauties: LottiesVintageAttic, ThriftingNifties, BashsToyBoxes, SpeakerBlock, AuntieNeeNee
FlyingFobs: Atomic39, Frederike11, adayatthebeach2, ribbonextravaganza, coralnbeads
ImaginariumShop: NattysRandomStuff, Dark1art, ArtShoppeCrafts, FlowerStudio13, BelleAnnDesigns
fowlkesmazyck: MagicalCase, casesinstyle, SarahRobertsonShop, PandoraStyleCharms, JinxiesBeads
FluffItBakery: SweetBitesRichmond, SouthernCakeToppers, PandoraStyleCharms, JinxiesBeads, TreasuredGems365
DadeisDead: hereonart, FunFunkyU, RayofSunshineGlass, creabonbon, SweetSugarPixels
InkPaperArt: SerenitysWay, KnotThatNautical, JGHandcraftedCards, ClemsCards, PhotosbyMM
TouchofClassMemorial: SarahsPuzzles, ZlitcheStitchez, deasycrafter, konalovecrafts, ElectronicCigarettes
BellaVitaDesignsYona: GabesSprayPaintArt, misterlisters, MamaPileggi, hereonart, RayofSunshineGlass
ZlitcheStitchez: deasycrafter, OliviasLoops, GreatGiftsToGo, PureLoveCrosses, MrPaint
SweetCupCrafts: MMsJewelry, PaisleyParkVintage, ViviansCrown, MrPaint, HoopsPlus
misterlisters: StillTreasured, SewSweetTots, MamaPileggi, LeChateauWoods, kidsvintage
OliverGirls: dummymummyuk, LittleCiciShop, nostalgicjapan, Frederike11, BellatiqueFabrics
OffKilterKnits: JoDonJewelry, PandoraStyleCharms, JinxiesBeads, TreasuredGems365, Jewelryliz
VsSweetVeganTreats: SweetBitesRichmond, JoDonJewelry, PandoraStyleCharms, JinxiesBeads, TreasuredGems365
billjamespainting: Machlev, ChristopherOakden, FedwellFarm, BellaVitaDesignsYona, GabesSprayPaintArt
NaesDreamDenim: duckyDenim, MamaPileggi, kidsvintage, MeanKids, PandoraStyleCharms
TeamCuenod: DMaxArt, kinkcircuit, ArtByAmaris, shivajiartstudios, AKBworkshop
CollegeQuilts: PCAShoponline, PigeonPoint, PhotosbyMM, JoDonJewelry, MantisDesign
cocamia: OldCootWoodandWax, TheLavenderFarmShop, Mullicamomsoycandles, MrPaint, OdditiesVintage
60sStore: DonnaMaggioDesigns, ZumbaFashions, DMMonogramming, TeaseCouture, NULABA
ForkandFlowers: BettyBirds, LeChapelle, MrPaint, TwoGuysWed, SugarDame
CheshireStrokes: DMaxArt, ArtByAmaris, kinkcircuit, shivajiartstudios, AKBworkshop
PerfectlyPoshParties: Tinasuniquedesigns, PandoraStyleCharms, JinxiesBeads, TreasuredGems365, JoDonJewelry
PrintedYesterday: PandoraStyleCharms, JinxiesBeads, TreasuredGems365, MelindasVintage, Jewelryliz
EtherealsEden: OnHallowedGround, MelindasVintage, MissionHouse, JinxiesBeads, TreasuredGems365
RNWebStudio: TheCritterArtist, MikeHaroArt, Natasha354, FranchaCavitt, GabesSprayPaintArt
AzMtnBlue: DIGDIN6, CrystalCoutureDesign, MamaPileggi, HandPaintedTees, misterlisters
CottonwoodDecor: SerenitysWay, ClemsCards, JGHandcraftedCards, MadeWithMarzipan, DearestDaisyUK
ACEshirts: MamaPileggi, DeadbeatCustoms, kidsvintage, PandoraStyleCharms, JinxiesBeads
AngelWhispererDawn: PamiesPatterns, funjewls4u, SheebeezAccessories, UnderTheMysticTree, bylaurab
edvivan: jesske000, silvertime925, beautynpizzazz, AnticqueShop, CoinDelight
MarysLoveLetters: SteveSimpsonShop, LolaMontejo, RingsmuthWelding, FeyMosacis, PauzaDamascusArt
FishFinProductions: JaimeKupfner, SweetSerendipityCaps, 3LittleCatsDesign, GaSouthernLights, CollsCoveredBoxes
EnigamiInk: DMaxArt, ArtByAmaris, ArtbyElizabethK, TheCanvasCorner, Sissishop
EidahLovesYou: KellBellsCreations, RagBabyDesigns13, littleBOWSdelivery, Chloescheerbows, ChasingSif
CraftandAlterations: SatinNTat, goodswithlove, HandmadebyMellon, GreenwomansDyes, AfricanFabric
StaibockBuuda: MENTOSDRIVE, CHUCHULove, WheelhouseLeather, FabulouslyFlorida, artbymalahkai
TwoHootStudio: laurenmtrump, WasteYrPrints, LivingSpiritDesign, TheLadyAgnesShoppe, pinkllamaprint
BadBadSeedVintage: MichellesNYC, MikaylasBooks, LovinHateStreet, FayesFabFinds, TRINKETSandTREASURE1
AnaBananaLB: CourageousCats, ReformedMetals, RyanTokoku, MagicalCase, PrincessJewelsByCaly
Spoonangels: PandoraStyleCharms, JinxiesBeads, TreasuredGems365, Jewelryliz, JoDonJewelry
DItYshop: Clairvoyantmedium, MrPaint, Frederike11, ribbonextravaganza, coralnbeads
RuffsNStuffs: PetsLoveBlingToo, PandoraStyleCharms, JinxiesBeads, TreasuredGems365, JoDonJewelry
ArrowsmithForge: KCsStudio44, WearableSpoons, FanBingBing, CammieCouture, JoDonJewelry
OfureDesigns: OliviasLoops, CraftsByDre, GreatGiftsToGo, PureLoveCrosses, TwoGuysWed
WineDine: PandoraStyleCharms, JinxiesBeads, TreasuredGems365, Jewelryliz, JoDonJewelry
AlenaBlissYou: JollyAccessories, KellBellsCreations, OhlalaPretties, RagBabyDesigns13, PrimPrincess27
SuzysJewelryShop: OnTheBeSide, HoopsPlus, MMsJewelry, Teresafashioncorner, PaisleyParkVintage
KnotKnitShop: elementofwonder, JeromeMcDonaldArt, YorktownCrafts, AnnaKnittingShop, junjieshop
MemsAttic: MrPaint, BellatiqueFabrics, JoDonJewelry, PandoraStyleCharms, JinxiesBeads
Exotica520: SikkFab, MyLittleVintageDress, HexzySales, IngridsSkatingDress, ElizaDaysVintage
EfimsPaintings: TheCritterArtist, KulliMaslova, EvaSzorcFineArt, ZhannaArt, DogandPetPaintings
MonsterMotel: PandoraStyleCharms, JinxiesBeads, TreasuredGems365, TheLadyAgnesShoppe, Jewelryliz
TiarasArtCraftCreat: Malamutemax, MrPaint, PandoraStyleCharms, JoDonJewelry, JinxiesBeads
HandmadeVeils: Decorrencia, ArtShoppeCrafts, FlowerStudio13, DIYbyEricaB, MrPaint
CoinDelight: GlassCokeBottle, WellLovedTreasures, recyclemamaj, selectedcraft, silvertime925
LiebeKoleMarie: ribbonextravaganza, coralnbeads, Frederike11, dummymummyuk, BowsBlingSupply
DpistolS: HoopsPlus, ThriftingNifties, MrPaint, KidsChairs, PandoraStyleCharms
GlamNGrace: LulabellesEmbroidery, EllePrelleDesigns, HandPaintedTees, DMMonogramming, DeadbeatCustoms
GreenwomansDyes: SimplyDyes, emilygraceclothing, AfricanFabric, iPadhoodie, KARYMUSA
LordDesigns: LocalLivingSA, CitySeamsHandbags, LovelyClassyFinds, JoDonJewelry, CammieCouture
AlissaBrunelliPhoto: PandoraStyleCharms, JinxiesBeads, TreasuredGems365, Jewelryliz, JoDonJewelry
ProdigyBoutique: GabesSprayPaintArt, RayofSunshineGlass, hereonart, PandoraStyleCharms, JinxiesBeads
YleCreations: MMsJewelry, PaisleyParkVintage, ViviansCrown, NeronaStreet, HoopsPlus
TheTechNeck: ChasingSif, ArtsyiPhoneCases, JollyAccessories, PrincessJewelsByCaly, OliviaClaireBows
MnMGlamping: HandmadeChandeliers, Tesher, LottiesVintageAttic, ThriftingNifties, PhotosbyMM
NifteyThrifter: MyLittleVintageDress, HexzySales, IngridsSkatingDress, SikkFab, ElizaDaysVintage
aMatterOfChoice: TreasuredGems365, JinxiesBeads, PandoraStyleCharms, Jewelryliz, JoDonJewelry
SimplementeErika: TheThingsTheyCarried, hereonart, RayofSunshineGlass, FunFunkyU, pinkllamaprint
CeCeFabulousFinds: ThriftingNifties, MrPaint, KidsChairs, Emotionless02, PaisleyParkVintage
OstrichOriginal: CitySeamsHandbags, LeChateauWoods, MoradoBags, LadyBirdesign, SANTAFELEATHER
KidSwagz: BrightFlowerHeadband, LanaArta, GlitteryBugz, BlueRibbonBling, Chloescheerbows
camipantiesandpurses: TribalTees, TopTopps, DIGDIN6, AzMtnBlue, CrystalCoutureDesign
SaffireWolf: JumpingJackalope, Ducky333, ingrainedwoods2, VarmCountry, KidsChairs
lepetitmagaz: BsEce, MrPaint, CraftingEssentials, PandoraStyleCharms, JinxiesBeads
TRINKETSandTREASURE1: jomannjewels, ThriftingNifties, Izzabellas, SparklingDezign, BlazinBeader
LuluFunJewelry: ArtPendant, JoDonJewelry, MrPaint, JinxiesBeads, TreasuredGems365
anniescabin: soniahalejak, MrPaint, TheresaNPieces, MMsJewelry, Mintalist
VaVaOutlet: DeadbeatCustoms, PandoraStyleCharms, JinxiesBeads, TreasuredGems365, Jewelryliz
PulpoInk: DMMonogramming, TeaseCouture, GeekJock, DIGDIN6, AzMtnBlue
AKGirlCrystalsnGlitz: UnderTheMysticTree, PamiesPatterns, NovaSingularities, SheebeezAccessories, SoftsidedJewelry
RPCustoms: byClementine, ArtsyiPhoneCases, ArtPendant, BekkaBeek, JollyAccessories
GoinkGoink: StinkyStickers, ShizzlerMtG, Chloescheerbows, ChasingSif, ArtsyiPhoneCases
WheelhouseLeather: FERRERMARBLEGRANITE, MENTOSDRIVE, GlyAccessories, Diewithoutit, LadyBirdesign
beFLUFFED: misterlisters, StillTreasured, FrediaCreations, SewSweetTots, MamaPileggi
blgirard2451: JollyAccessories, RagBabyDesigns13, PandoraStyleCharms, JinxiesBeads, TreasuredGems365
PatsBowsandmore: PrimPrincess27, lacova, OliviaClaireBows, OhlalaPretties, SuperCuteClippies
MaddClay: MatMantra, TheShabbyCraftShack, creationsbyrobyn1, GaSouthernLights, CollsCoveredBoxes
TheUrbanSett: LocalLivingSA, serendipitypillows, BellatiqueFabrics, LilBlueBirdy, PandoraStyleCharms
TeaseCouture: DMMonogramming, HandPaintedTees, EllePrelleDesigns, misterlisters, BellaVitaDesignsYona
DemoRSShop: SteveSimpsonShop, LolaMontejo, RingsmuthWelding, FeyMosacis, PauzaDamascusArt
WTFapparel: LuvSiccLA, ShopRikitik, OGCHEAP, NativeCoutureN8V, EllieAtMaluno
DressTales: LeChateauWoods, MamaPileggi, misterlisters, Emotionless02, kidsvintage
NotThing: CALIHustle, KajunsCrafts, ParacordPatriot, Acmeproducts, Waggonerra1
WorksbyMadelaine: TristanTannerDesigns, pinkllamaprint, WasteYrPrints, KvoFolkArt, ErinPhippsDesigns
BsEce: PandoraStyleCharms, JinxiesBeads, TreasuredGems365, Jewelryliz, MelindasVintage
PlumTattoos: IzzyKayPrints, SethCarterArt, Lifeinwatercolor4u, FranchaCavitt, MikeHaroArt
PaintingsbySTERLING: DMaxArt, Sissishop, ArtByAmaris, ImaginedImpressions, ArtbyElizabethK
CoCoMichelles: JinxiesBeads, TreasuredGems365, PandoraStyleCharms, Jewelryliz, NeronaStreet
StarZarts: Natasha354, longdogart, MikeHaroArt, StantonStudiosArt, GabesSprayPaintArt
Purpurapansaboutique: SatinNTat, goodswithlove, AfricanFabric, iPadhoodie, 60sStore
TartyFrog: Malamutemax, MrPaint, socraftyuk, ClemsCards, JGHandcraftedCards
AmericanLandWP: MantisDesign, CammieCouture, HaileyPoo, LocalLivingSA, ThriftingNifties
JAPcreations: AllStarrJewels, EarringsByJane, HomeFeathers, HappyHippyCrafts, MMsJewelry
ErwinDiamond: BekkaBeek, Anitahafner, ArtPendant, OrgonizeYourLife, BsEce
PhotoArtLetters: MissAmybuys, BubblegumBlowfish, LotusCards, WalkinsWelcome, EtherealPix
CHHRF: TreasuresfromtheBird, BabyBegoniaProps, BellatiqueFabrics, MrPaint, nostalgicjapan
RachiPrints: TheLadyAgnesShoppe, JamiesDoodles, PandoraStyleCharms, JinxiesBeads, TreasuredGems365
PinkBrushstrokes: CraftyLeaves, PaintingsforPJ, depressivepaintings, MikeHaroArt, Natasha354
3LittleCatsDesign: DigitalDesignz1, PureLoveCrosses, PandoraStyleCharms, JinxiesBeads, TreasuredGems365
HandiCraftbyJane: MaddeeLu, pajuxies, Lemonadedaily, SweetTeaNme, nicebabycrochet
HappyLemonVintage: TheRenegadeVintage, CrystalCoutureDesign, DIGDIN6, AzMtnBlue, HandPaintedTees
ManchesterDoula: TreasuredGems365, JinxiesBeads, JoDonJewelry, Jewelryliz, NeronaStreet
CraftedByCharley: CraftyLeaves, PaintingsforPJ, NotGREY, depressivepaintings, CitySeamsHandbags
Tekmates: PandoraStyleCharms, JinxiesBeads, TreasuredGems365, Jewelryliz, JoDonJewelry
ZakGarnerStudios: WasteYrPrints, pinkllamaprint, KvoFolkArt, MikeHaroArt, TheLadyAgnesShoppe
FairyElephants: MrPaint, CitySeamsHandbags, LeChapelle, LovelyClassyFinds, BellatiqueFabrics
PadmaMalas: MrPaint, PureLoveCrosses, Insomny, ViviansCrown, GreatGiftsToGo
MAJOECREATIONS: ribbonextravaganza, coralnbeads, Frederike11, dummymummyuk, Ecohippychic
WalkinsWelcome: LotusCards, RayofSunshineGlass, hereonart, PandoraStyleCharms, JinxiesBeads
WeddingBoxes: ArtShoppeCrafts, FlowerStudio13, PictureYourSeat, LabiosDeMel, VintageWinery
NoBoxArt: ArtEquine, HoshiTae, TheCanvasCorner, SouthernBlessings002, MrPaint
CraftoftheCrone: OGCHEAP, nicebabycrochet, SweetTeaNme, HaileyPoo, AlwaysRoomforJello
Allaboutchevron: ToteAmour, NappyHeadedBeaus, VinylGraphix, BsEce, serendipitypillows
LiveOnTheEdge: Bearsfromspares1, StuffandStuffies, lovenikkih, littlewildlings, TheSpottedMushroom
JaimeBouteilles: TheLavenderFarmShop, TheresaNPieces, CGDbyMeryl, MrPaint, MMsJewelry
STEVECUMMINGSART: TristanTannerDesigns, SouthernBlessings002, CzaraArt, kimbrenasdesigns, pinkllamaprint
DesignerSilkFlorals: SteveSimpsonShop, LolaMontejo, RingsmuthWelding, FeyMosacis, PauzaDamascusArt
konalovecrafts: deasycrafter, ZlitcheStitchez, ONLY1NICOLE, OliviasLoops, GaSouthernLights
MyCatLego: GreatGiftsToGo, PureLoveCrosses, LavantaCoffee, MrPaint, DigitalDesignz1
ZumbaFashions: DonnaMaggioDesigns, TeaseCouture, DMMonogramming, ThreadbareLab, WyldeBrambleEmporium
Trimleyweddings: LeChapelle, JollyAccessories, PandoraStyleCharms, JinxiesBeads, TreasuredGems365
Jewelryliz: NeronaStreet, JinxiesBeads, TreasuredGems365, JoDonJewelry, PandoraStyleCharms
HandblastDesign: HoughtonsHouses, Craftsbyfitkittymama, MantisDesign, PCAShoponline, ThriftingNifties
KimsKreations806: TreasuredGems365, JinxiesBeads, PandoraStyleCharms, Jewelryliz, FarahLarki
JKDesigns4303: ThriftingNifties, KidsChairs, MrPaint, PandoraStyleCharms, MelindasVintage
DIIISS: HabitCollections, AnticqueShop, RegentCollectables, TheMcMatosCollection, MarksMidCenturyMod
WeddingEssential: SikkFab, MyLittleVintageDress, HexzySales, IngridsSkatingDress, ElizaDaysVintage
LovelockGreenBridal: BettyBirds, LeChapelle, RagBabyDesigns13, MrPaint, TwoGuysWed
WoodCraftier: PartyFlask, MrPaint, PandoraStyleCharms, JinxiesBeads, TreasuredGems365
SchulzeWildlife: EtherealPix, LotusCards, LauraInkPhotography, PhotosbyMM, TriMoonArt
DTSJunior: LottiesVintageAttic, BashsToyBoxes, ThriftingNifties, chloeleecrafts, JKDesigns4303
QUEENOFQUEENSDOLL: CrochetbyRosaG, LittlePollyPockets, WeeWhimzyWardrobe, ChansCrochetCreation, MrPaint
Paintedpoint: ArtByAmaris, TheCanvasCorner, kinkcircuit, shivajiartstudios, AKBworkshop
ITZEE: OGCHEAP, WordPouch, MrPaint, LocalLivingSA, LivingSpiritDesign
LightShapes: hereonart, RayofSunshineGlass, FunFunkyU, creabonbon, SweetSugarPixels
SmokingPope: WasteYrPrints, TheLadyAgnesShoppe, OhSoPrintableDesigns, JamiesDoodles, OfficialWondercraft
CraftySue22: Trailblazer28, SoftsidedJewelry, JoDonJewelry, Lovile, MeltingWithLight
Artisanoexports: Lovile, SoftsidedJewelry, JoDonJewelry, NovaSingularities, junjieshop
BobbyandBambis: PetsLoveBlingToo, JoDonJewelry, PandoraStyleCharms, JinxiesBeads, TreasuredGems365
BubblingSugar: PartyFlask, ShoppingInParis, CraftingEssentials, TeacupMarket, PandoraStyleCharms
Milkcart: ThriftingNifties, MrPaint, KidsChairs, PandoraStyleCharms, JinxiesBeads
CandraCase: JokoCase, EfenCase, ManaCase, SenoCase, JarwoCase
DonnaTouchBurlesque: ribbonextravaganza, coralnbeads, Frederike11, dummymummyuk, Ecohippychic
WasteYrPrints: TheLadyAgnesShoppe, pinkllamaprint, RayofSunshineGlass, hereonart, laurenmtrump
ONLY1NICOLE: TheLavenderFarmShop, GreatGiftsToGo, PureLoveCrosses, OliviasLoops, PandoraStyleCharms
VagabondLeather: NaomisJewelleryshop, OliviasLoops, MrPaint, GreatGiftsToGo, PureLoveCrosses
sfdesigns79: EllePrelleDesigns, LulabellesEmbroidery, HandPaintedTees, DMMonogramming, TeaseCouture
LegoMarket: YleCreations, JoDonJewelry, PandoraStyleCharms, JinxiesBeads, TreasuredGems365
ElenaBelova: WeeWhimzyWardrobe, PandoraStyleCharms, JinxiesBeads, TreasuredGems365, JoDonJewelry
deathart: inmyattictoyours, MileHillAntiques, MakeThingsPretty, jomannjewels, GreatValues
TheCocktailGoddess: AllThatGlittersHC, TreasuredTinys, MrPaint, Tinasuniquedesigns, PandoraStyleCharms
AmberandIndigo: JJHut, Lovile, SoftsidedJewelry, BlazinBeader, SparklingDezign
CanadianMonkeys: SiansThings, JJNWF, RestlessApparel, lovenikkih, PurplePlumCrochet
MoiMili: lacova, OliviaClaireBows, MrPaint, ArtsyiPhoneCases, JollyAccessories
JoesBowTieEmporium: faboandme, bluemolasses, RoyalTendency, MedfordandBrooke, StylePowerShop
MikaylasBooks: MichellesNYC, LovinHateStreet, FayesFabFinds, TRINKETSandTREASURE1, ThriftingNifties
TheCanvasCorner: kinkcircuit, shivajiartstudios, AKBworkshop, StudioKQL, ArtByAmaris
drptclothing: DimensionZero, DeadbeatCustoms, TopTopps, MamaPileggi, MeanKids
Ruby